386=Windows 3.x Virtual Device Driver
73k=TI-73 Application
a4r=Macromedia Authorware Packaged File without Runtime
a5r=Macromedia Authorware Packaged File without Runtime
a6r=Macromedia Authorware Packaged File without Runtime
a7r=Macromedia Authorware Packaged File without Runtime
acm=Microsoft Audio Compression Manager Codec
action=Automator Action
acx=Atari ST Executable
aos=Nokia Phone Add-on Software
app=SymbianOS Compiled Application
arx=Autodesk AutoCAD Runtime Extension
ax=DirectShow Filter Plugin
b=BASIC Source
bas=BASIC Source
bas=Visual Basic Module
bat=MS-DOS Batch File
btapp=uTorrent Application
cgi=Common Gateway Interface
cla=Java Class
class=Java Class
cls=Java Class
cmd=Command File
cnv=Microsoft Document Converter
cod=Microsoft C Compiler Output
com=Executable File
com=Windows Command File
cpl=Control Panel Item
dll=Windows Dynamic Linked Llibrary
drv=Windows Device Driver
ds=TWAIN Data Source
ear=Java Enterprise Archive
ebs=E-Prime E-Run 1.x Script
ebs2=E-Prime E-Run 2.x Script
etk=ETcl Kit
exe=Executable File
fas=Compiled Fast-Load AutoLISP
gadget=Windows Sidebar Gadget
hdi=Autodesk AutoCAD Heidi Device Interface
hta=Microsoft HTML Application
icd=SafeDisc Encrypted Executable
iec=Internet Explorer Converter
ipa=iPhone / iPod Application
irc=Internet Relay Chat Script
irx=Sony Playstation 2 Executable
isu=InstallShield Uninstall Script
jad=Java Application Descriptor
jml=JSP Markup Language
jnlp=Java Network Launch Protocol Descriptor
jse=JScript Encoded Script File
lim=Limit Compressed Archive
lrplugin=Adobe Photoshop Lightroom Plug-in
lrwebengine=Adobe Photoshop Lightroom Web Gallery
m3g=Mobile 3D Graphic
mco=Live Messenger Content Object
mpc=Musepack Audio
mpn=Mophun Game
mrc=mIRC Script
msc=Microsoft Management Console Snap-in
nbp=NeoBook Plugin
nexe=Native Client Executable
ocx=ActiveX Custom Control
pba=PanelBuilder Application
pef=Preferred Executable Format
pif=Program Information File
pmp=Adobe Premiere Meta-Plugin
prm=Adobe Premiere Plugin
prmp=Adobe Premiere Plugin
pva=PanelView Application
pyc=Python Bytecode
pyd=Python Dynamic Module
qpx=QuickTime Player Extension
qts=QuickTime System File
rsc=SymbianOS Compiled Resource
s1=Freescale S-record File
s2=Freescale S-record File
s3=Freescale S-record File
scf=Windows Explorer Shell Command
scr=Microsoft Windows Screensaver
ser=Java Serialized Object
spss=SPSS Script
sqr=SQR Script
swc=Adobe Flex Component
swf=Shockwave Flash
swz=Adobe Flex Signed RSL
sx=Freescale S-record File
tos=Atari ST TOS Executable
trc=Oracle Trace
ttp=Atari ST TOS Executable With Parameters
u3i=U3 Package Information
u3p=U3 Package
vb=VBScript Script
vbe=VBScript Encoded Script
vbs=VBScript Script
vdf=VirtualDub Video Filter
vxd=Windows Virtual Device Driver
waf=Internet Explorer Cache
wgt=Opera Widget
widget=Yahoo! Widgets Widget
wll=Microsoft Word Add-In
wsc=Windows Script Component
wsf=Windows Script File
wsh=Windows Script File
x16=Macromedia Extension Plugin 16
x32=Macromedia Extension Plugin 32
xaml=Extensible Application Markup Language
xap=Silverlight Application Package
xba=OpenOffice.org Basic Module
xbap=XAML Browser Application
xex=Xbox 360 Executable