3ga=3GP Audio File
3gpa=3GP Audio File
669=Composer 669 Module
8svx=Amiga 8SVX Sound
aa=Audible Audiobook
aa3=Sony ATRAC3 Audio
aac=Advanced Audio Coding
aax=Audible Enhanced Audiobook
ac3=AC-3 Compressed Audio
adpcm=Dialogic ADPCM Audio File
adts=Advanced Audio Coding
adx=ADX Encoded Audio
afs=ADX Audio Container
ahx=AHX Encoded Audio
aif=Audio Interchange File
aifc=Compressed AIFF Audio
aiff=Audio Interchange File
al=A-Law Compressed Audio File
alac=ALAC Encoded Audio
alaw=A-Law Compressed Audio File
alp=Ableton Live Pack
alw=A-Law Compressed Audio File
amf=Advanced Module Format Music
amr=Adaptive Multi-Rate Audio
amr-wb=Adaptive Multi-Rate WideBand Audio
ams=Velvert Studio Music Module
aob=DVD Audio Object
apc=A-Pac Compressed Audio
ape=Monkey`s Audio File
apl=Monkey`s Audio Link
at3=Sony ATRAC3 Audio
atp=Sony ATRAC3 Audio
atrac=Sony ATRAC3 Audio
atrac3=Sony ATRAC3 Audio
au=Sun Audio File
aud=Command and Conquer Compressed Audio
avr=Audio Visual Research File
awb=Adaptive Multi-Rate WideBand Audio
bd=Ben Daglish Music
bgw=Final Fantasy XI Music
bun=Cakewalk Bundle Data
bwf=Broadcast Wave Format Audio
caf=Core Audio Format
caff=Core Audio Format
cda=CD Audio Track
cdda=CD Audio Track
cdg=CD+G Karaoke File
cel=Adobe Audition Loop
cfa=Adobe Premiere Conformed Audio
cmf=Creative Labs Music File
cvs=DR-97 Digital Recorder Audio
dab=Digital Audio Broadcasting File
df2=Defractor 2 Instrument
dfc=Defractor Instrument
dls=Downloadable Sounds File
dmf=X-Tracker Music Module
drm=Cubase Drum Map
ds2=DSS Pro Voice
dsm=Dynamic Studio Module
dsp=Dynamic Studio Professional Module
dss=Digital Speech Standard Voice
dtm=DigiTrekker Music Module
dts=DTS Encoded Audio File
dvf=Sony Digital Voice Recorder Audio
ear=ETI Audio Recording File
efa=Ensoniq ASR File
efs=SQ-80 Sample
emd=Advanced 16-Bit Tracker Module
emy=eMelody Ringtone
epm=Electric Pipes Music
etw=Enter-Tech Recorded Audio
evrc=Enhanced Variable Rate Codec Audio
exl=Korg X3 Song
exs=Emagic EXS-24 Instrument
far=Farandole Composer Music Module
fff=Gravis UltraSound Sound Bank Data
flac=Free Lossless Audio Codec File
flt=StarTrekker Music Module
fsb=FMOD Sample Bank
fti=FamiTracker Instruments Data
ftm=FamiTracker Music
gig=Tascam Gigastudio Instrument
gmc=Game Music Creator Music
gsm=GSM Audio File
gt2=Graoumf Tracker 2 Module
gtk=Graoumf Tracker Module
gtk1=Graoumf Tracker Module
gtk2=Graoumf Tracker 2 Module
gym=Sega MegaDrive Music
h0=Magix Movie Edit Pro Audio Data
hrt=Hornet Packer Module
ibk=Creative Labs FM Banks
idd=MIDI Instrument Definition
idf=MIDI Instrument Definition
ime=iMelody Ringtone
imelody=iMelody Ringtone
imy=iMelody Ringtone
ins=Cakewalk Sonar Instrument Definition
isma=IIS Smooth Streaming Audio
it=Impulse Tracker Music Module
its=Impulse Tracker Music Sample
itz=Impulse Tracker Music Module
j6s=Ricoh Digital Camera Sound
k25=Kurzweil K2500 Data
k26=Kurzweil K2600 Data
kar=MIDI Karaoke Song
kit=NI Battery Drum Kit
la=Lossless Audio Compressed Data
lrc=Lyrics Data
lvp=Avaya Voice Player Audio
m1a=MPEG Audio Layer 1 File
m2a=Mpeg-2 Audio
m3u=M3U Playlist File
m3u8=M3U Playlist File
m4a=Mpeg-4 Audio
m4b=Mpeg-4 Audio Book
m4e=Yamaha Motif ES Multi Part Editor File
m4p=DRM Protected AAC File
m4r=iPhone Ringtone
mcg=Compressed CD+G Karaoke File
mdi=MIDI Music
med=OctaMED Music Module
mid=MIDI Music
midi=MIDI Music
mka=Matroska Audio
mkw=MKW Compressed Audio
mld=MFi Phone Ringtone
mlp=Meridian Lossless Packing Audio
mmf=SMAF Audio
mod=Music Module MOD
mp1=MPEG Audio Layer 1 File
mp2=Mpeg-1 Audio Layer 2 File
mp2a=Mpeg-2 Audio
mp3=MPEG Audio Layer 3 File
mp3g=MP3+G Karaoke File
mp4=Mpeg-4 Audio
mp4a=Mpeg-4 Audio
mpa=Mpeg Audio File
mpga=MPEG Audio Layer 3 File
mpy=RCA Lyra Audio File
msv=Sony Memory Stick Recorded Voice
mt2=MadTracker 2 Music Module
mte=MadTracker Envelope
mti=MadTracker Instrument
mtm=MultiTracker Music Module
mtp=MadTracker Pattern
mts=MadTracker Sample
mts=Music Time Pro Music
mtx=MadTracker Extension
mus=Finale Music File
mxl=Compressed MusicXML Notation
mxmf=Mobile XMF Audio
mzp=Mozart Percussion
nap=Napster Secured Audio
nkc=Kontakt Library Data
nki=Native Instruments Kontakt Library
nkm=Native Instruments Kontakt Multi Library
nkr=Kontakt Resource Container
nkx=Kontakt Monolith Container
nsa=Nullsoft Streaming Audio
nst=Noise Tracker Music Module
nwc=NoteWorthy Composer Music
oga=Ogg Vorbis Compressed Audio
ogg=Ogg Vorbis Compressed Audio
ogx=Ogg Vorbis Compressed Audio
okt=Oktalyzer Music Module
oma=Sony ATRAC3 Audio
omg=Sony OpenMG Audio
omg=Sony ATRAC3 Audio
oml=OtsAV Media Library
omx=OtsAV Media Library Information
ots=OtsAV Album
pcm=RAW PCM Audio Data
plst=SmartMusic Playlist
ppc=Adobe Presenter Audio
ppcx=Adobe Presenter Audio
psg=ZX Spectrum 128 Audio
ptm=Polytracker Module
pvc=Panasonic VM1 Voice Data
qcelp=QCELP Compressed Audio
qcp=QCELP Compressed Audio
ra=Real Audio Sound
ram=Real Audio Sound
rax=Real Audio Sound
rel=Nokia 5510 Phone Recorded Audio
rex=ReCycle Loop Data
rhz=RHZ Ringtone
ring=Grandstream IP Phone Ringtone
rmi=MIDI Music
rmj=RealJukebox Unsecure Media Clip
rmx=RealJukebox Secure Media Clip
rng=Nokia Phone Ringtone
rns=Reason Audio
rol=AdLib Visual Composer Music
rti=Real Tracker Instrument
rtm=Real Tracker Module
rtpl=Nokia Phone Binary Ringtone
rts=Real Tracke Sample
rtttl=Nokia Phone Text Encoded Ringtone
rtttl=Ring Tones Text Transfer Language File
rtx=Nokia Phone Ringtone
s3m=Scream Tracker 3 Module
s3z=Scream Tracker 3 Module
saf=MusicMatch Jukebox Secure Audio File
sb=Signed Byte Audio Data
sbi=Creative Labs Sound Blaster Instruments
sbk=EMU SoundFont v1.x Banks
sd=Sound Designer Audio
sd2=Sound Designer 2 Audio
sds=MIDI Sample Dump Standard
sdx=MIDI Sample Dump Exchange
sf2=EMU SoundFont v2.x Banks
sfd=SoundStage Sound File Data
sfi=SoundStage Sound File Info
sfk=Sound Forge Peak Data
sfl=Sound Forge Audio Data
sfr=Sonic Foundry Sample Resource
shn=Shorten Compressed Audio
sid=Commodore 64 Music
sma=SmartMusic Accompaniment
smaf=SMAF Audio
smp=SampleVision Audio Sample
snd=Macintosh Sound Resource
sngw=Devil May Cry 4 Audio Data
snu=Dead Space Game Audio Data
spx=Speex Compressed Audio
stm=Scream Tracker Module
stz=Scream Tracker 2 Module
svd=Roland Saved Patches
svx=Amiga 8SVX Sound
sw=Signed Word Audio File
swa=Shockwave Audio
syh=Synchomatic Instrument
syw=Yamaha SY Series Sample
tak=TAK Compressed Audio
tsp=TrueSpeech Compressed Audio
tta=True-Audio Compressed Audio
ult=Ultratracker Module
uni=MikMod UniMOD Music Module
vag=Sony Playstation Compressed Audio
val=Olympus Voice Reorder Audio
vm1=Panasonic VM1 Voice Data
voc=Creative Labs Sound Blaster Sound
vox=Dialogic ADPCM Audio
vpm=Garmin Voice Data
vqf=TwinVQ Audio
vrf=Ventrilo Audio Recording
w01=Yamaha SY Series Sample
w02=Yamaha SY Series Sample
w64=Sony Wave64 Audio
wav=Windows Waveform Sound
wav=Broadcast Wave Format Audio
wave=Windows Waveform Sound
wax=Windows Media Audio Redirector
weba=WebM Audio
wfb=Turtle Beach Wavefront MIDI Bank
wfd=Turtle Beach Wavefront Drum Set
wfp=Turtle Beach Wavefront Patch
wma=Windows Media Audio
wow=Grave Composer Music Module
wv=WavPack Audio
wvc=Wavecraft Audio
x0a=Yamaha Motif XS Song Data
x0e=Yamaha Motif XS Editor File
x0p=Yamaha Motif XS Pattern Data
x0s=Yamaha Motif XS Song Data
x0v=Yamaha Motif XS Voice Data
xi=FastTracker 2 Instrument
xm=FastTracker 2 Music Module
xma=Xbox 360 Native Audio
xmf=Mobile XMF Audio
xmf=Extensible Music Format File
xmf0=Extensible Music Format File
xmf1=Extensible Music Format File
xmi=Extended MIDI Song
xms=XMS Tracker Module
xp=FastTracker 2 Pattern
xspf=XML Shareable Playlist File