acg=IBM Personal Communications SNA Configuration
acw=Accessibility Wizard Settings
aiw=FDS Imaging Software Configuration
apv=BenMAP APV Configuration
avs=Avid Media Composer Settings
bau=OpenOffice.org AutoText Data
bif=Novell GroupWise Initialization File
bsi=BSPlayer Configuration
cav=CAView Configuration
cf=Configuration File
cf=Sendmail M4 Configuration File
cfg=Configuration File
cfi=Xilinx iMPACT Configuration
cha=mIRC Chat Settings
chat=mIRC Chat Settings
cms=Connection Manager Service Provider Data
cnf=Configuration File
cns=Client Connection Manager Config
con=Configuration File
conf=Configuration File
config=Configuration File
cos=Capture One Settings
cpm=Cisco Secure Policy Manager Settings
crp=CureROM Profile
csf=Adobe InDesign Color Settings
ctf=AVG Update Control File
cui=Autodesk AutoCAD Custom Workspace
cw_=CorelDraw Workspace Description Data
cxz=PND Scanner Configuration
dbl=DAZ Brick Light
dpf=DOpus v9 Exported Settings
dps=DOpus Exported Settings
dst=RAD Studio Desktop Settings
dsx=DAZ Studio Configuration
ecf=Microsoft Outlook Extension Configuration File
eftx=Microsoft Office 2007 Theme
emv=LabVIEW EuroMeV Configuration File
epr=Adobe Photoshop AME Preset
fiv=CruiseComp Forest Inventory Settings
flx=The Bat! Folder Settings
fni=ALCUGS Settings
fsi=FSI Viewer Configuration
ftp=General FTP Profile Data
gcsx=Microsoft Office SmartArt Color Definitions
ghi=NCSA Mosaic Configuration
gpd=Generic Printer Description
hrt=Heart-Profit Configuration
ht=HyperTerminal Settings
htaccess=Apache Webserver htaccess File
iaf=Microsoft Outlook Internet Account Settings
icf=Implementation Configuration File
idc=Internet Database Connector
idq=Internet Data Query File
iem=Internet Explorer Maintenance Extension
ini=Initialization File
ins=Microsoft Windows Internet Settings File
ipk=iPack Configuration File
isp=Internet Sign-up Settings
jeq=JetAudio Equalizer Settings
joboptions=Adobe Acrobat Distiller Job Options
kys=Adobe Photoshop Keyboard Shortcut Settings
ldt=Belkin Loadout Manager Data
list=APT Package Resource List
lrsmcol=Adobe Photoshop Lightroom Smart Collection Settings
mbxcfg=Molebox Configuration Data
mca=Massive Midi Setup
mcr=DataCAD Keyboard Macro
mcs=ModelCHECK Start Config
milk=WinAmp MilkDrop Plugin Preset
my=Yudit Settings
nam=Novell Netware Namespace Data
nmdsdcid=Media Player Settings
nnm=HP OpenView Network Node Manager Configuration
nqs=Network Queuing System Hosts File
nts=Lotus Traveler Bootstrap File
ops=Microsoft Office Profile Settings
ora=Oracle Configuration
pbk=Remote Access Phonebook Data
pc2=Autodesk AutoCAD Plotter Configuration
pc3=Autodesk AutoCAD Plotter Configuration
pcp=Autodesk AutoCAD Plotter Configuration
pip=Microsoft Office Personalized Menu
plist=QuickTime Preferences File
pnd=Pegasus Mail Mailbox Configuration Data
poc=Codesoft Printer Object Configuration
pref=Configuration File
prefs=Configuration File
prx=Windows Media Encoder Settings
pssc=Windows PowerShell Session Configuration
pvs=Parallels Desktop Configuration File
rc=Runtime Configuration File
rdp=Remote Desktop Connection Settings
rfi=BlackBerry Email Filter
root=Bind Root Nameservers Configuration
sdg=OpenOffice.org Configuration File
sdv=OpenOffice.org Configuration File
set=General Settings File
settings=Configuration File
sfs=Sibelius Configuration File
sif=Windows NT Setup Information File
smr=Smedge2 Job Settings
sob=OpenOffice.org Configuration File
soc=OpenOffice.org Configuration File
sod=OpenOffice.org Configuration File
soe=OpenOffice.org Configuration File
sog=OpenOffice.org Configuration File
soh=OpenOffice.org Configuration File
stf=Microsoft Setup Table File
sxx=Adobe Flash Player Shared Object Settings File
sys=Windows System Configuration
tbf=Cadvance Toolbar File
thc=Therion Configuration File
trm=Terminal Settings
twc=TTWin Configuration File
uae=WinUAE Configuration
ubr=Web Capacity Analysis Tool Settings
ufi=UFOCapture V2 Settings
usc=USC Module Definition
vcl=Varnish Configuation Language File
vis=FDS Imaging Software HW Configuration
vmc=Virtual Machine Configuration
vmcx=Virtual Machine Shell Information
vnc=Virtual Network Configuration
vpn=Shrew Soft VPN Configuration
vps=Virtual CD Copy Template
vsc=Mcafee VirusScan Settings
vuc=Virtual Talker Settings File
wlm=HP-UX Workload Manager Configuration
wme=Windows Media Encoder Session Profile
ws=IBM Personal Communications WorkStation Profile
wst=WinSSHD Settings
xc=RSNetWorx Configuration
xcu=OpenOffice.org Configuration File
xiu=Chiasmus Configuration
zap=Windows Software Installation Settings
zcfg=HLGuard Z Config
zcfg=Zoom Search Engine Config
zzb=MultiView Configurable Toolbar
zzc=MultiView Connection Details
zzd=MultiView Wizard Defaults
zze=MultiView Emulation Details
zzf=MultiView File Transfer Configuration
zzk=MultiView Keyboard Mapping
zzp=MultiView Configurable Pop-up Menu
zzt=MultiView Terminal Configuration
zzu=MultiView Uninstall File