12134=Autodesk AutoCAD Tool Catalog
323=H.323 IP Telephony Data
356=IPC-D-356 Data
3dc=iGO 3D Building Data
3gt=3D Graphic Tools Model
4db=4D Database Structure Data
4dc=4D Database Compiled Structure
4dd=4D Database Data File
4dr=4D Database Data Resource
73b=TI-73 Backup
73c=TI-73 Constant
73l=TI-73 Data List
8xg=TI-83/84 Plus Group
8xk=TI-83/84 Plus Application Upgrade
8xs=TI-83/84 Plus String
8xv=TI-83/84 Plus Variable
a26=Atari 2600 ROM Image
a52=Atari 5200 ROM Image
a5d=Macromedia Authorware Model
a6d=Macromedia Authorware Model
a78=Atari 7800 ROM Image
a7d=Macromedia Authorware Model
aam=Adobe Authorware Map
aas=Adobe Authorware Segment File
abk=CorelDraw AutoBackup
abk=Kodak EasyShare Addressbook Data
abz=Pro/ENGINEER AutobuildZ Data
ac$=Autodesk AutoCAD Temporary File
aca=Microsoft Agent Character Animation
acf=Microsoft Agent Character Data
acg=Microsoft Agent Character Preview
ach=NACHA ACH File
aci=WebCGM ACI File
acl=Microsoft Office AutoCorrect List
acm=Adobe Photoshop Command Button
acq=AcqKnowledge Data
acr=ACRobot Script
acs=Microsoft Agent Character
acsm=Adobe Content Server Manager Data
ad=After Dark Screensaver
adb=Intuit Quicken Address Book Data
adb=Adlib Express Server Data
adb=Alphacam Diecut VB Macro
adc=Active Desktop Calendar Dataset
adf=Act! Database File
adg=Albatross Design Group 3D Scene
adi=AutoCAD Device-Independent Binary Plotter File
adj=Farsite Adjustment Data
adm=Windows Administrative Template
adm=Alphacam Diecut Param Macro
adn=Microsoft Access Blank Project Template
adp=Alphacam Diecut Post Data
adr=z-Tree Address Data
adt=Alphacam Diecut Tool Data
adt=Act! Template
aeb=Alphacam Wire EDM VB Macro
aem=Alphacam Wire EDM Param Macro
aep=Alphacam Wire EDM Post Data
aet=Adobe After Effects Template
afb=Alphacam Flame VB Macro
aff=FRAMES Air Flux File
afm=Alphacam Flame Param Macro
afp=Alphacam Flame Post Data
aft=Ancestry.com Family Tree Database
afu=NX Motion Simulation-RecurDyn Function
ahu=Adobe Photoshop Hue/Saturation Layer
aia=ANDI/netCDF Chromatography Data
aim=AIMMS ASCII Model File
ajb=Alphacam Water Jet VB Macro
ajm=Alphacam Water Jet Param Macro
ajp=Alphacam Water Jet Post Data
alb=Alphacam Laser VB Macro
alc=Microsoft Dynamics AX Application Label Cache
ald=Microsoft Dynamics AX Application Label Data
alf=Act! Database Log
ali=Application Loader Information
alm=SiRFDemo GPS Almanac File
alm=Alphacam Laser Param Macro
aln=ClustalW2 Alignment Data
alp=Alphacam Laser Post Data
alv=Adobe Photoshop Levels Settings
alx=Application Loader XML
amb=AIMMS Model Base
amb=Alphacam 2D/3D Mill VB Macro
ami=AMI BIOS Firmware Update
aml=AutoMate Markup Language Data
amm=All My Movies Database
amm=Alphacam 2D/3D Mill Param Macro
amo=AIM Module
amp=Alphacam 2D/3D Mill Post Data
amt=Alphacam 2D/3D Mill Tool Data
amt=ArtMoney Table
amz=Amazon MP3 Downloader Data
anc=Alphacam NC Program
anl=Alphacam Nest List
annot=FreeSurfer Annotation
ant=Xilinx ISE ANT File
ant=Radio Mobile Antenna Definition
aod=Microsoft Dynamics AX Application Object Data
apa=RSView Application Manager Archive
apb=Alphacam Punch VB Macro
api=Adobe Photoshop Ink Colors Setup
apm=Alphacam Punch Param Macro
app=Alphacam Punch Post Data
application=ClickOnce Deployment Manifest
apr=Gerber Aperture Data
apt=Alphacam Punch Tool Data
apt=Nimbus 7 SAMS APRIORI Data
aq=Ancestral Quest Database
aq1=AptiQuiz Test
aqa=Ancestral Quest Database Index
aqa=AptiQuiz Test Result
aqg=BenMAP Air Quality Grid
arb=Alphacam Router VB Macro
arc=Tinker Archive
arc=AMPAC Archive File
arg=Autodesk AutoCAD User Profile
arm=Alphacam Router Param Macro
arm=Armadillo Protected File
arp=Alphacam Router Post Data
ars=Adobe After Effects Render Settings
art=Alphacam Router Tool Data
artwork=iOS Artwork Data
asb=Alphacam Stone VB Macro
asc=Autodesk 3D Studio Scene in ASCII
ask=AskSam Database
asl=Miranda IM Emotions Definition
asm=Alphacam Stone Param Macro
asp=Alphacam Stone Post Data
ast=Adobe Color Separation Table
asu=Toolbook Package Definition
atb=Alphacam Lathe VB Macro
atc=Autodesk AutoCAD Tool Catalog
ath=Athena Task File
ath=Alphacam Lathe Thread
atm=Alphacam Lathe Param Macro
atn=Adobe Photoshop Actions Data
atoms=Ribbons Atoms Definition
atp=Alphacam Lathe Post Data
att=Alphacam Lathe Tool Data
auc=Microsoft Dynamics AX Application Unicode Object Cache
ava=Animation Master Model
avc=Kaspersky Anti-virus Database
avd=Avery LabelPro Database
aw=Answer Wizard Index
awd=AWARD BIOS Firmware Update
awr=Ad-Aware Reference Data
axe=Autoroute Export Data
axm=AXMEDIS Object
axt=Adobe Photoshop Replace Color Setup
b3d=B3D 3D Object
b64=Base64 Encoded Data
bad=Microsoft Exchange Non-Delivery Report Message
bag=PMMail Mail Index
bap=Blaze Audio Wave Information
bbd=Xilinx Black Box Definition
bbi=LinkOne Publisher Book Data
bbk=Treepad Database Blob Backup
bbk=Sage Fixed Assets Database Backup
bc=BitComet File
bc!=BitComet File
bck=HP OpenVMS Backup File
bcp=Microsoft SQL Server Data Replication Data File
bdb=Blaise Database
bdd=CARA Sound Radiation Data
bdic=Google Chrome Dictionary
bdm=Blaise Data Model
bdmv=Blu-ray Disc Information File
bdp=Microsoft Exchange Non-Delivery Report Bad Mail Pointer
bdr=Microsoft Exchange Non-Delivery Report Body
bek=BitLocker Encryption Key
bfi=Blaise Database BFI Data
bgr=Girder Binary Plugin
biar=Business Intelligence Archive Resource
bim=Zemax Binary Image Surface Data
bip=TSG Spectral Data
bit=Xilinx Bitstream Data
bix=Biblook Index Data
bjk=Blaise Database BJK Data
bk1=FlashGet Database Backup
bk2=FlashGet Database Backup
bk3=FlashGet Database Backup
bk4=FlashGet Database Backup
bkl=KeyCarbon Binary Keystroke Log
bkp=Wavelab Backup Plan
bla=Blaise Datamodel
blb=Treepad Database Blob Data
blb=Act! Blob Data
blf=MasterWorks Data
blf=CLFS BaseLog
blm=Rightmove Bulk Load Mass Data
bln=Golden Software Blanking
blt=AOL Instant Messenger Buddy List File
blx=Magellan Mapsend Map Data
bmi=Blaise Metafile
bmk=Windows Help Bookmark
bml=Blaise Mode Library
bnl=MicroSim PCBoard Netlist
bnskin=BeatNik Clock Skin
bof=Babylon License Data
bonds=Ribbons Bonds Definition
boo=Boo Encoded Data
box=CARA Loudspeaker Design
box=Kodicom Video Metadata
bpd=Business Plan Pro Plan
bpdx=Business Plan Pro Plan
bpf=F-Secure Base Policy File
bpf=Business Plan Pro Formula
bpk=Blaise Database BPK Data
bpm=Sybase Business Process Model
brs=Adobe RoboHelp Browse Sequence
brw=Calyx Point Borrower
bsb=NOAA Nautical Charts
bsb=Xilinx Base System Builder Playback File
bsd=Xilinx BSDL File
bsdl=Xilinx BSDL File
bsdl=Xilinx Text Design Output
bsk=Blaise Database BSK Data
btr=Btrieve Database
bts=Blaise Specification
btsearch=BitTorrent Search Engine Data
btskin=BitTorrent Skin Data
btt=Microsoft BizTalk Tracking Profile
btw=Bartender Format Data
bvf=VentaFax Phonebook
bwm=Blaise Cati Menu Definition
bws=Website X5 Project Backup
bxi=Blaise Datamodel Properties
c2r=Windows Media Center Click-to-record File
c3d=Coordinate 3D Data
c4d=Cinema 4D Data
cae=Abaqus/CAE Model Database
cag=Microsoft ClipArt Gallery Database
cam=Minolta Vivid 3D Scanner Camera Data
cap=Libpcap Captured Packets
cat=Quicken IntelliCharge Categorization
cav=Kintraks Database
cbg=CyberGauge Data File
cca=cc:Mail Archive
ccc=Microsoft Comic Chat Conversation Data
ccf=Cryptload Container Format File
cch=.NET Security Cache
cck=COMcheck-Ez Data
ccr=ASTM Continuity of Care Record
cde=CADKEY Dynamic Extension
cdf=ANDI/netCDF Chromatography Data
cdf=ECMG Content Definition File
cdf=netCDF Data File
cdf=Affymetrix Chip Description File
cdf-ms=ClickOnce Compiled Manifest
cdl=Common Data Form Language File
cdx=dBASE Compound Index
cdx3=Cochlear Data Exchange File
cel=Affymetrix Probe Array Results File
cfl=IMVU Product Data
cft=Microsoft SQL Server Data Replication Conflict Tables
cgc=Compressed Gamecube Disk Image
cha=Adobe Photoshop Channel Settings
chk=Epidata Defined Checks
chk=Saved File Fragment
chp=Affymetrix Probe Array Results File
chq=Help Combined Full-text Search
chr=Autodesk 3D Studio Max Character File
cht=ZSNES Game Cheat
cht=ICQ Saved Chat Session
chw=Compiled HTML Help Index
ch_=Compressed CHM File
ci=CitectSCADA Data
ci=iBlaze Case Information File
cid=EL-CID Data
cif=ColorImpact File
cim=Cimplicity HMI Screen
cip=Ghost Keylogger Logfile
ck9=Cook'n Cookbook Backup
clb=ICQ Contact List Data
clf=ListPro Data
clpi=Blu-ray Disc Clip Information
clr=Farsite Color Data
clt=MetaVR 3D Cultural Features Data
clx=Ceelox SecureMail Secure Message
cm2=Poser Camera Data
cmbl=Vernier Logger Pro Data
cmc=Comic Collector Collection Data
cmd5=CrystalMaker V5 Data File
cmdf=CrystalMaker V2 Data File
cmp=General CADD Component Data
cmw=Custom Maintenance Wizard Data
cmz=Poser Compressed Camera Data
cng=CryptoNG Encrypted File
cnm=Pegasus Mail New Message
codec=Rockbox Codec
color=Ribbons Color Mapping
con=SQL Script Constraints
cont=Panasonic Camcorder Metadata
contact=Windows Vista Contacts Data
co_=Compressed COM File
cpa=Cadstar PCB Design
cpd=Adobe RoboHelp Cache Project Database
cpi=Lifo-Pro Consumer Price Index
cpi=MS-DOS Code Page Information
cpt=Mail.dat Component File
cptl=Adobe Captivate 5 Template
cpx=Character Set Translation Table
cqt=Mail.dat Container Quantity Data
cr2=Poser Character
cri=PLS-CADD Criteria
crl=Certificate Revocation List
crpt=Cryptosaurus Encrypted File
crs=Document Conversion Resource
crtx=Microsoft Excel 2007 Custom Chart Template
cryptra=Cryptra One Time Pad Encrypted File
crz=Poser Compressed Character
csa=Cadstar Schematic Design
csb=Corel Binary Script
csc=Corel Script
csm=Mail.dat Container Summary File
ctf=ECMG Content Transformation File
cts=GodswMobile Contacts Transfer Backup
ctt=MSN Messenger Contact List
ctx=CyberTracker Exported Data
cw5=CodeWallet Pro 5 Data
cw6=COMPRESS Vessel Model File
cyl=Ribbons Cylinder Definition
cys=Clustify Summary File
cys=Cytoscape Session File
czr=Everest Advanced Report
dab=OrangeCD Database
daf=Digital Anchor Data
dal=Download Accelerator Plus List
dam=DeltaMaster Analysis Model
das=DeltaMaster Analysis Session Data
dat=Nero BackItUp Drive Image
dat=General Data File
dat=DataFlex Database File
dat=Affymetrix Image Data File
dat=Treepad Database
data=Analysis Studio Data
data=General Data File
datt=STK Processed Intermediate Terrain File
da_=Compressed DAT File
db=General Database File
db2=dBASE II Database
db3=Berkeley DB3 Database
dba=WaveLab Audio Database
dbb=Skype Binary Log File
dbc=Microsoft Visual FoxPro Database
dbc=DAZ Studio Brick Camera
dbe=ActiveSync Backup
dbi=Treepad Database DBI Data
dbk=Treepad Database Backup
dbk=dBASE Database Backup
dbm=DAZ Studio Brick Material
dbs=SQLBase Database
dbs=Microsoft SNA Server Database
dbt=Autodesk AutoCAD DBConnect Template
dbw=Alfrin Pedigree Database
dbx=Microsoft Outlook Express Folder Database
dca=Visual Basic Active Designer Cache
dcb=DAZ Studio Custom Brick
dcf=OMA DRM Content Format
dcl=DumpSec Report
dct=Adobe Illustrator Dictionary
dcw=Digital Chart of the World Data
dcw=Draft Choice for Windows Drawing
dd=OMA Download Descriptor
ddb=Protel 99SE Design Database
ddd=Verity Server Data
ddp=Dinkey Dongle Parameter File
ddr=DDRemote Saved Parameters
dfa=SecuROM Manual Activation Request.
dgnlib=Bentley MicroStation Design Library
dic=Microsoft Office Custom Dictionary
did=Verity Server Index Data
dim=Direct Internet Message Encapsulation Data
dime=Direct Internet Message Encapsulation Data
dit=Windows 2000 Active Directory Data Store
dix=Stonevoice Translator Custom Dictionary
dix=Apertium Monodix Dictionary Data
djp=DJPrint Data
dl=FLEXnet Manager Debug Log
dlc=JDownloader Download Link Container
dlis=Digital Log Interchange Standard File
dl_=Compressed DLL File
dmp=Windows Memory Dump
dnc=DANCE Database
dns=Microsoft Windows DNS Server Database
doe=Arena Model File
dol=Gamecube Executable DOL
dom=DIMPLOT Domain Definition
dot=Ribbons Dot Definition
dpb=DataPilot Data
dpf=F-Secure Default Policy File
dpf=COMPRESS Drafter Data
dpi=Document Processing Information
dr=OMA DRM Rights Object XML
dra=Dragon Recorded Audio
drc=OMA DRM Rights Object WebXML
dri=Microsoft SQL Server Data Replication Index
dri=Excellion Drill File
drl=Excellon Drill File
drl=Altium Binary Drill File
drr=Altium Drill Report File
dsb=Barudan Embroidery Data
dsc=Nikon Disk Identification
dsc=Softimage 3D Scene
dsc=Bio-Rad DNA Scan Code
dsd=DAZ Studio Deltas
dsd=Diet Studio Data
dsf=DSON Support File
dsft=Microsoft App-V Differential SFT File
dsk=RAD Studio Saved Desktop
dsn=ODBC Data Source Name
dso=DAZ Studio Object
dspackage=Desktop Sidebar Package
dst=Tajima Embroidery Data
dsv=DAZ Studio Vertex Map
dsz=ZSK Embroidery Data
ds_store=Mac OS X Folder Settings
dt=Proben1 Dataset
dt0=DTED Level 0 Data
dt1=DTED Level 1 Data
dt2=DTED Level 2 Data
dtf=Symantec Q&A Database Data
dtsx=Microsoft SQL Server Integration Services Package
dtt=Data Transfer To iSeries File
dtw=My Better Desktop Layout
dtyp=DTYPE Database
dtype=DTYPE Database
duf=DSON User File
dus=Readiris Font Dictionary
dvc=Dragon NaturallySpeaking Vocabulary
dve=Video Toaster Digital Video Effect
dvfh=D-Link IP Camera Metadata
dvo=Cook'n Cookbook Recipe
dwk=Autodesk AutoCAD Drawing Lock
dwl=Autodesk AutoCAD Drawing Lock
dwl2=Autodesk AutoCAD Drawing Lock
dwp=Microsoft Sharepoint Web Part Description
dwq=Dreamweaver Saved Query
dwr=Dreamweaver Saved Query
dx=OpenDX Data
dyn=Tinker Dynamics Computation Data
eac=EmEditor Auto Complete File
ebd=IBIS Electrical Board Description
ecc=Dvdisaster Error Correction File
ecg=Electrocardiography Data
eci=Ettercap Info Log
ecp=Ettercap Packet Log
ecu=TunerPro ECU Configuration
edat=E-Prime E-DataAid 1.x File
edat2=E-Prime E-DataAid 2.x File
edb=Microsoft Exchange Database
edf=ESRF Data Format
edi=ENVI-met Information File
edl=Edit Decision List
edn=Adobe DRM Activation Key
eds=Electronic Data Sheets
edt=ENVI-met Data File
eep=Project64 Saved Game Data
eep=EEPROM Data
efl=Encryptafile Encrypted File
egp=Easy Grade Pro Gradebook
eid=eID Middleware Data File
eif=Envex Import Format File
elf=Gamecube Executable ELF
elm=Microsoft Frontpage Theme Package
emb=Wilcom Embroidery Data
emc=Striata Encrypted E-mail Attachment
emlx=Apple Mail Message
emn=Pro/ENGINEER ECAD IDF File
emo=Miranda IM Emotions
emrg=E-Prime E-Merge 1.x File
emrg2=E-Prime E-Merge 2.x File
ems=eMachineShop Data
enc=Uuencoded Data
end=Tinker End File
enl=EndNote Library Data
enlx=EndNote X Compressed Library Data
epf=Microsoft Exchange Security Settings
eph=SiRFDemo GPS Ephemeris File
epk=E-Prime E-Studio 1.x Package File
epk2=E-Prime E-Studio 2.x Package File
eqn=KaleidaGraph Macro
err=Error Log File
es=E-Prime E-Studio 1.x Experiment File
es2=E-Prime E-Studio 2.x Experiment File
esp=ACD/Labs Dataset
est=Streets & Trips Map Data
etd=Adobe Reader EBX Transfer Data File
evd=Enigma Vector Database
evn=Retrosheet Event File
evt=Microsoft Windows Event Viewer Log
ewd=Enigma Flight Planner Database
exc=Microsoft Word Exclude Dictionary
exd=Microsoft Office Control Information Cache
exif=Exchangeable Image Information File
exm=Exam Document
exo=Motorola EXORmacs Data
exp=Affymetrix Experiment File
extrep=Sage External Representation
ex_=Compressed EXE File
f06=Nastran ASCII Results
fat=Zinf Theme
fav=Microsoft Outlook Navigation Bar
fb!=FlashGet Unfinished File
fbk=Microsoft Dynamics NAV Database Backup
fbl=iGO Map file
fbn=Sony-Ericsson Phone Flash Filesystem
fc2=Poser Face Data
fca=Omnis Web Client Form Cache
fcs=Flow Cytometry Standard Data
fcs=Canon ZoomBrowser EX Data
fcz=Poser Compressed Face Data
fdc=AutoCAD Fields Description
fde=AFP Form Definition
fdf=Format Description File
fes=Topicscape Fileless Link Export
ffa=Microsoft Find Fast Status File
ffl=Microsoft Find Fast List
ffo=Microsoft Find Fast Cache
ffp=FLAC Fingerprint Data
ffp.txt=FLAC Fingerprint Data
ffr=Gminos FFR Card
ffs=Samsung S5230 Firmware Factory FS File
fft=Farm Foresty Toolbox Data
ffx=Microsoft Find Fast Index
fga=Folder Guard Attributes File
fgd=Folder Guard Data File
fgp=Folder Guard Password File
fhx=DeltaV Database File
fib=File Investigator Internal Database
fid=File Investigator Internal Database
fig=SNES ROM Image FIG
fih=File Investigator Internal Database
fil=ACL for Windows Data
fip=File Investigator Internal Database
fiv=File Investigator Internal Database
fl=DRM Forward Lock
flb=FileMaker Pro Label Data
fld=WinFlash Flashcard Settings
flf=Microsoft Dynamics NAV License File
flr=WinFlash Results File
fls=WinFlash Flashcard Source
flt=WinFlash Compiled Test
flu=WinFlash Flashcard Source (new)
flw=Fluke LinkWare Database
flz=WinFlash Compiled Flashcard
fm=FileMaker Pro Data
fm5=FileMaker Pro Data
fmd=Farsite Custom Fuel Model
fmp=FileMaker Pro Data
fmp12=FileMaker Pro 12 Database
fms=Farsite Moisture Data
fnc=Frogans Player Network Certificate
fo=602XML Filler Form Data
fob=Microsoft Dynamics NAV Object Container
fp3=FileMaker Pro V3 Data
fp5=FileMaker Pro V5 Data
fp7=FileMaker Pro V7 Data
fpt=Alpha Five Memo Data
frac=Tinker Fractional Coordinates
frd=Frequency Response Data
fro=dBASE IV Compiled Report
fso=Adobe Flash Media Server Remote Shared Object
fsp=iGO Primo Map File
ftf=Xperia X10 Phone FTF Firmware
ftr=CONDOR Flight Track
ful=Microsoft Backup File List
fve=BitLocker Full Volume Encryption File
fxb=Cubase FX Bank
fxp=Cubase FX Program
fxt=MakeMusic Finale Script
g3p=Grandprix 3 Car Physics
gam=General Game Data File
gam=Aureas Theme File
gam=Gamma Card Data
gas=Grab-a-Site Data File
gb=Nintendo GameBoy ROM Image
gba=GrabIt Batch
gba=Nintendo GameBoy Advance ROM Image
gbc=Nintendo GameBoy Color ROM Image
gbd=Garmin Waypoints Data
gbl=Gerber Bottom Layer Data
gbl=Genesis Bitmap Layout
gbo=Gerber Bottom Overlay Data
gbp=Gerber Bottom Paste Mask Data
gbp=Genesis Bitmap Pattern
gbs=Gerber Bottom Solder Mask Data
gbx=Gerber PCB Data
gc=GraphClick File
gcd=General CADD Drawing
gci=Gamecube Game Save
gcm=Gamecube Disk Image
gd1=Gerber Drill Drawing Data
gd2=Gerber Drill Drawing Data
gd3=Gerber Drill Drawing Data
gd3=SNES ROM Image GD3
gdd=Gerber Drill Drawing Data
gdi=Sega Dreamcast GDI Image
gdt=Guitar and Drum Trainer Song
gep=GeneXproTools Data
ges=GESS Data
gfs=Immersioni Profile
gft=GSP Family Tree Data
gfx=FactoryTalk View Display Data
gg=Google Desktop Gadget
gid=FRAMES Global Input Data File
gin=Affymetrix Gene Information Library
gko=Gerber Keep Out Layer
gmax=Autodesk Gmax File
gml=Girder Plugin
gnp=GNPeak Output File
gnx=GNPeak Numeric Output File
gp1=GamePark.cz Client Data
gpb=Gerber Pad Master Bottom Data
gpd=Xbox360 Game Play Data
gpg=GnuPG Signature/Key
gpi=Garmin Point of Interest Data
gpk=Wavelab Audio Peak
gpro=Genealogy Pro Data
gps=GOM Player Skin
gpt=Gerber Pad Master Top Data
gpx=GPS Exchange Format Data
graph=Mascopt Graph Data
grc=Affymetrix Grid Control File
gre=GRETEP Data
group=Unix Filesystem Group Quota Data
grv=Microsoft Office Groove File
grx=Getright Exported List
gs=GemStone Document
gsf=GEMPAK Map File
gsf=z-Tree GameSafe Data
gsf=Gwyddion Simple Field File
gsx=Genecyst Emulator Saved State
gtar=GNU Tar Archive
gtd=GT Designer 2 Data
gthr=Microsoft SharePoint Portal Server Gather Log
gtl=Gerber Top Layer Data
gto=Gerber Top Overlay Data
gtp=Gerber Top Paste Mask Data
gts=Gerber Top Solder Mask Data
gwy=Gwyddion Surface Data
gxc=General CADD Pro Component
gxh=General CADD Pro Hatch
gxm=General CADD Pro Macro
gxv=General CADD Pro Menu
gzl=Go!Zilla File List
h1c=Microsoft Help Collection Definition
h1k=Microsoft Help Keywords Index
h1s=Microsoft Help Compiled Help Data
h1t=Microsoft Help Topic Definition
h1v=Microsoft Help VTopic Definition
h323=H.323 IP Telephony Data
h5=HDF5 Data File
hbk=Hex Workshop Bookmark File
hbp=HBPredicT Output
hcg=HCLab Document
hch=General CADD Hatch
hcl=HotDocs Clause Compressed Archive
hcx=BinHex 2.0 Encoded Data
hd2=Poser Hand Data
hdf=Hierarchical Data Format File
hdl=HotDocs Clause Library
hdr=Microsoft IIS NNTP Header Data
hdr=Mail.dat Header File
hdr=DataFlex Database Header
hdz=Poser Compressed Hand Data
hep=Hummingbird HostExplorer Profile
heu=Adobe Flash Player Cache Metadata
hex=BinHex Encoded Data
hi=MAME Highscore Data
hi1=FindinSite Database
hi2=FindinSite Database
hi3=FindinSite Database
hi4=FindinSite Database
hi5=FindinSite Database
hi6=FindinSite Database
hi7=FindinSite Database
hi8=FindinSite Database
hi9=FindinSite Database
hif=Quicken Online Data
his=FindinSite Database
hl_=Compressed HLP File
hmt=HighMAT File
hnr=iGO Primo Defined Routes
hol=Microsoft Outlook Holiday Data
hps=HP Digital Sender Information
hpx=MetaVR 3D Model
hqx=Macintosh BinHex Encoded File
hr2=Poser Hair Data
hrc=Softimage 3D Model
hru=SWAT HRU Data
hrz=Poser Compressed Hair Data
hsk=Nimbus 7 SAMS HSK Data
hsp=iGO Primo Histspeed File
hss=Adobe Photoshop Hue/Saturation Data
hst=General History File
htw=Webhits Template
hxh=Microsoft Help 2 Merged TOC
hxi=Microsoft Help 2 Compiled Help Index
hxq=Microsoft Help 2 Query Data
hxr=Microsoft Help 2 Combined Attribute Index
hxw=Microsoft Help 2 Merged Index
iak=Mail.dat Information Access Key
ibk=Treepad Database Index Backup
icc=ICC Profile
icl=Mail.dat International Container Label File
icm=Image Color Matching Profile
icn=OpenFlight Model
icns=Mac OS X Icon Resource File
icr=Impromptu Content Report
id=Lotus Notes User ID File
id2=Live Messenger Custom Emoticon Metadata
idb=Intuit Quicken Home Inventory Data File
idf=Intermediate Data Exchange File
idoc=SAP IDoc File
idx=Citrix Program Neighborhood Database Index
idx=Canon ZoomBrowser EX Database Index
idx=LaTeX Unsorted Index Data
idx=Intuit Quicken Index Data
idx=Microsoft SQL Server Constraints
idx=dBASE Database Index
idx=Treepad Database Index
ies=IESNA Photometric Data
ie_=Compressed IEC File
ifc=Industry Foundation Classes Data
igc=Anime List Builder Data
igm=Indigo Material Data
ign=Adobe RoboHelp Ignore List
ihx=IN-HEH Timeline Database
ilg=LaTeX Index Generation Log
ima=Zemax Image Surface Data
imd=Integration Manager Database
ime=IncrediMail Emotions Data
imf=IncrediMail Letter File
img=Magellan Meridian Map Image
imi=Magellan eXplorist Map Image
ind=LaTeX Processed Index Data
ind=SQL Script Indexes
index=MySQL Binlog Index File
indx=CALDB Index
ing=MasterCook Ingredients Data
ink=Tablet PC Digital Ink
inl=Inspiration Custom Symbol Library
inp=Abaqus/CAE Input Data
inp=WinUAE Input Recorder Data
ins=Microsoft SMS Instructions
int=Tinker Internal Coordinates
in_=Compressed INI File
ipc=IPC-D-356 Data
ipf=F-Secure Incremental Policy File
iqd=Cognos Impromptu Query Definition
irl=HomeVision Infrared Signal Data
irx=Brewer Lamp Irradiance File
ise=InstallShield Express File
isk=Druvaa inSync Client Key
isl=Inno Setup List
isml=IIS Smooth Streaming Publishing Point Definition
isr=InstallShield Uninstall Information
is_=Compressed ISP File
itl=iTunes Library File
itn=TomTom Route Data
itp=GROMACS Include Topology
itw=InTouch With Database
iuf=LandMark Incremental Update File
ix=dtSearch Desktop Index
ixc=ArcVIEW Geocode Coverage Index
ixr=XL Reporter Template
ixs=ArcVIEW Geocode Index
jan=Janome Embroidery Design
jbf=Paint Shop Pro Browser Cache
jcd=FlashGet Download Database
jdf=Job Definition Format File
jdx=JSpell Dictionary Data
jed=Xilinx JEDEC Data
jedec=Xilinx JEDEC Data
jef=Janome Embroidery Data
jgp=QWS3270 PLUS Session Parameter File
jks=Java Key Store
jmf=Job Messaging Format File
job=Windows Task Scheduler Job Object
jod=Microsoft Jet OLEDB
jrn=SAP POS Journal File
jsk=JetAudio Skin
jsml=JSim Markup Language Data
json=JavaScript Object Notation
k=LS-DYNA Input Data
k7=DCMO6 Emulator Tape Image
kal=Hondata KManager Calibration Data
kct=Knit Visualizer 1.0 Chart
keychain=Mac OS X Keychain
kfx=Kofax Capabilities File
khd=Microsoft Dynamics AX Kernel Help Documentation
klr=KeyCarbon Keystroke Log
kmy=KMyMoney Data
ktd=Microsoft Dynamics AX Kernel Text Data
kvc=Knit Visualizer 2.0 Chart
kvl=Knit Visualizer Library
kwi=KIWI Navigation Data
kyr=Lotus Domino Server Keyring
lab=Wavelab CD/DVD Label Set
label=FreeSurfer Label
lac=Cognos Local Authentication Cache
las=Log ASCII Standard
lay=Pro/ENGINEER Layout
lay=ArchiCAD PlotMaker Layout
lay=Rhino 3D Layer
layout=Adobe Premiere Workspace Layout
lbk=ArchiCAD PlotMaker Layout Book
lc=L0phtCrack Password Database
lcb=Kodak EasyShare Album List
lcf=ArchiCAD Library Container File
lcn=Trymedia License Data
lcp=Farsite Landscape Data
lcs=L0phtCrack Password Database
ld=MoTeC Telemetry Log
ldata=JSim Line Data Format
ldb=Microsoft Access Database Lock
ldf=Microsoft SQL Server Transaction Log
ldf=LDAP Data Interchange Format File
ldif=LDAP Data Interchange Format File
ldp=Active Directory Exported LDAP Data
ldx=Lingoes Dictionary
lef=EnCase Logical Evidence File
lef=LEN Exchange Format File
lex=Microsoft Office Custom Dictionary
lgc=Microsoft Windows Application Log
lgd=Microsoft Windows Application Log
lgf=Microsoft Windows Application Log
lgg=Microsoft Windows Application Log
lgh=Microsoft Windows Application Log
lgh=Intouch HMI Historical Log File
lgt=Vaisala LTraX Data
lic=General License File
lif=Intuit TurboTax Information Archive
lin=Autodesk AutoCAD Linetypes
lis=SQR Printer Output
lix=ExtendSim Simulation Software Library
lkp=Microsoft SMS Lookup File
llge=Microsoft Windows Application Log
lmx=Nokia Landmark Exchange File
lng=Adobe Acrobat Language Data
loc=TopoGrafix Location Data
lrcat=Adobe Photoshop Lightroom Catalog
lrdata=Adobe Photoshop Lightroom Data
lrdb=Adobe Photoshop Lightroom 1.0 Database
lrtemplate=Adobe Photoshop Lightroom Template
ls=Guitar Rig Loop Machine Data
lt2=Poser Light Data
ltf=Frogans Short-cut
ltz=Poser Compressed Light Data
ltz=Poser Light Data
lvd=Avery LabelPro Design Document
lxa=Microsoft Speech Lexicon
lxf=Compressed LEN Exchange Format File
lyt=Intuit TurboTax Install Log File
m2f=Maxthon 2 Browser Filter
m2p=GROMACS Mat2PS Data
m2p=Maxthon 2 Browser Plugin
m2s=Maxthon 2 Browser Skin
maa=MMANA Antenna Data
mab=Mozilla Address Book
mad=Microsoft Access Module Shortcut
map=WAsP Terrain Map
map=Map Data
mb1=Math Blaster 1 Data
mbl=Vernier Logger Pro Data
mbn=Sony-Ericsson Phone Main Firmware
mbox=Unix Mailbox
mbp=Modbus Poll Data File
mbp=Mobipocket Reader Data
mbs=Opera Mail Mailbox
mbx=Eudora Mailbox File
mbx=Microsoft Outlook Express v4 Mailbox
mc3=MC3D Document
mc6=Poser Material Collection
mcdb=Media Cache Database
mcf=MPRESS Control Format File
mcr=General CADD Macro
mcs=Intel MCS-86 Hexadecimal Object
mcs=Maximal Compressed Structure
mct=Live Messenger Content
mcz=Poser Compressed Material Collection
md=Sega Genesis ROM MD
md=Chaos Desktop Metadata
mdc=Cognos Cube File
mdd=Notation Composer Midi Device Description
mdd=Xilinx Microprocessor Driver Description
mdf=Microsoft SQL Server Database
mdm=HLM Multivariate Data Matrix
mdn=Microsoft Access Blank Database Template
mdo=Microsoft IIS Metabase Backup
mdr=ZX Spectrum Emulator Microdrive Cartridge Data
mdw=Microsoft Access Workgroup Data
mdx=dBASE IV Multiple Index
mem=Virtual Game Station Memory Card
mem=Medical Expense Manager Data
meta=Apache META File
metadix=Apertium Metadix Dictionary Data
mfasl=Mozilla Fastload File
mfd=Multiframe Design
mfl=Mozilla Fastload File
mfr=Moldflow Result
mfs=MetFS Encrypted File System
mg=MetaGuide Setup Data
mgc=Media Catalog MGC File
mgf=Materials and Geometry Format Data
mgi=Magellan eXplorist Map Image
mgi=Magellan Meridian Map Image
mib=SNMP MIB File
mim=MIME Encoded Data
mime=MIME Encoded Data
miniml=MINiML File
mir=Mail.dat Manifest Individual File
miv=MapImagery Vendor Profile
mix=VentaFax Voice Message Batch
mi_=Compressed MID File
mjd=Mime-encoded JDF
mkb=DVD Audio Media Key Block
mkd=Pervasive SQL Database
mks=TACT Data File
mld=Microprocessor Library Definition
mm=FreeMind MindMap
mm=Matrix Market File
mmap=MindManager Map File
mmb=Mobile Master Backup
mmc=Microsoft ClipArt Gallery Catalog
mmd=mAirList Metadata
mml=Media Catalog MML File
mmo=Memory-Map Overlay File
mmt=Nimbus 7 SAMS MMRVT Data
mmw=Microsoft Office Clip Organizer Catalog
mnc=Autodesk AutoCAD Compiled Menu
mni=Cerious Mandelbrot Image
mnr=Autodesk AutoCAD Menu Resource
mns=Autodesk AutoCAD Menu Source
mnu=General CADD Menu
mnu=Autodesk AutoCAD Menu Definition
mob=MobTV P2P File
model=Ribbons Model Definition
mol=Music Module List
mol=MDL Molecule File
mon=Wavelab Audio Montage
mot=MarcEdit Template
mot=Animation Master Motion Data
mp=MatrixPlot Data
mp+=Incite Media Assistant File
mpa=Mail.dat Postage Account File
mpb=My Phone Explorer Data
mpd=Microsoft Project Database
mpgindex=Adobe Premiere Mpeg Index
mph=COMSOL Multiphysics Data
mpi=Moldflow Plastics Insight Document
mpk=Project64 Memory Pack
mpl=AVCHD Playlist Data
mpls=Blu-ray Disc Movie Playlist
mpu=Mail.dat Mail Piece Unit File
mpw=Mapwel GPS Map
mrk=Kodak EasyShare Job Definition
mrk=Pro/ENGINEER Markup File
ms=Autodesk 3D Studio Max Script
msf=Altera Mask Settings File
msf=Mozilla Mail Folder Summary Data
msf=Miranda IM Skin
msk=Affymetrix Mask File
mskin=Maxthon Browser Skin
mso=Microsoft Office Rendering Data
mspm=Nanoeducator File
msr=Mail.dat Manifest Summary File
mss=Microprocessor Software Specification
msstyles=Windows XP Style Data
mst=Microsoft Windows Installer Transform
msw=Modbus Slave Workspace
mta=Samsung AllShare Metadata
mth=Derive Math File
mtw=Minitab Worksheet
mud=Textease Multi User Database
mvi=Autodesk AutoCAD AutoFlix Movie Command File
mvm=MAGIX PhotoStory Slideshow
mwl=Mighty Draw Windows Library
mxc=ArcVIEW Geocode Coverage ODB Index
mxd=ArcMAP Document
mxit=MXit Data
mxs=ArcVIEW Geocode ODB Index
mxt=Fortran 5 Data File
myd=MySQL MyISAM Table Data
myi=MySQL MyISAM Table Index Data
n64=N64 ROM Image
n80=PC8001 Rom Image
nab=Novell Addressbook
nanr=Nintendo Animation Resource
nap=NAPLPS Metafile
nbf=Windows Mobile Rom Upgrade File
nbh=HTC Hermes Rom Image
nbi=Nero BackItUp Information File
nbt=Nero BackItUp Template
nbu=Nokia Phone Backup Archive
nc=Geopath NC File
ncdb=NoteCase Pro Database
ncde=NoteCase Pro Encrypted Database
nch=Microsoft Outlook Express Folder Data
nco=Nero BackItUp Compressed Data
ncs=Lotus Notes Content Source
nc_=Nero BackItUp Child File
nda=Nero BackItUp Drive Image
ndb=Act! Notes Database
ndf=Microsoft SQL Server Secondary Database File
ndk=Lotus Notes Design Elements
ndots=Ribbons Polygon Definition
ndp=NET Deed Plotter File
ndr=Nikon Capture Image Dust Off File
nds=Nintendo DS ROM Image
ndx=Aston-Tate dBASE Database Index
nef=Nero BackItUp Encryption File
nes=NES ROM Image
nick=Microsoft Outlook 2000 Auto Complete Nick List
njb=Nikon Photo Index
nji=Nero BackItUp Job Information
njt=Nero BackItUp Job Template
nk2=Microsoft Outlook 2002 Auto Complete Nick List
nls=National Language Support
nnt=Eudora Addressbook Database
not=Adobe InCopy User Dictionary
nov=Native Instruments Battery Data
npk=MikroTik Router OS Upgrade Package
nsd=NRG Systems Symphonie Data
nsf=Lotus Notes Data
nsr=EMC NetWorker Directive File
nsx=Apollo HiPer-SIx Database Index
ntar=Network Trace And Retrieval Dump
ntf=Lotus Notes Template
ntm=Navitel 2.0 Map
ntx=Clipper Database Index
nv=NewViews Database
nwc=NavisWorks Cache File
oab=Microsoft Outlook Offline Address Book
ob!=Orbit Downloader Unfinished File
obi=Microsoft Outlook RSS Subscription Data
obs=WAsP Obstacle List
ocb=DOpus Configuration Backup
och=Viewsat FTA Receiver Channel List
ocs=OCS Inventory NG Data
od=Mascopt Data
oda=AIBO ODA File
odat=Hopsan Optimization Data
odn=Fluke Power Analyze Database
oeb=Outlook Express Backup Wizard Data
ofm=Melco Embroidery Data
ofr=Microsoft SMS Offer File
ok=Dot OK MD5 Hash
oly=AFP Overlay Resource
omd=Routing J Server Data
omf=Routing J Server Routing Data
omt=HLA Object Model Template
ond=Lotus Notes Database
onepkg=Microsoft OneNote Package
onetmp=Microsoft OneNote Temporary File
onetoc=Microsoft OneNote Table of Contents
onetoc2=Microsoft OneNote Table of Contents
onm=Outdoor Navigator Map
op2=Nastran Binary Results
opc=Office Upgrade Control
opi=OCR Processing Information
or2=Lotus Organizer 2 Data
or3=Lotus Organizer 97 Data
or4=Lotus Organizer 4 Data
org=Lotus Organizer Data
orient=Ribbons Orientation File
ost=Microsoft Outlook Offline Folder File
ov2=TomTom POI Database
ovf=Open Virtualization Format Data
ovw=Cubase WAVE File Overview
owc=WAsP Observed Wind Climate
p00=Commodore 64 Program Image
p2z=Poser Compressed Pose Data
p3=Primavera Project Planner Data
p3c=Primavera Project Planner Compressed Backup
p3t=Sony PlayStation 3 Theme
p7a=PKCS #7 Attached Signature
p7b=PKCS #7 Certificate Data in Base 64 Format
p7c=PKCS #7 Certificate Data
p7d=PKCS #7 Detached Signature
p7m=PKCS #7 Encrypted Message
p7r=PKCS #7 Certificate Request Response File
p7s=PKCS #7 Digital Signature
pab=Microsoft Outlook Personal Address Book
pad=Portable Application Description
pan=Panorama Database File
par=Mail.dat Postage Adjustment File
pay=z-Tree Payment File
pbn=Portable Bridge Notation Database
pbp=Sony PSP Firmware Update Image
pcap=Libpcap Captured Packets
pcapng=PCAP Next Generation Dump Data
pcbdoc=Altium PCB Document
pcblib=Protel PCB 3.0 Binary Library
pce=TurboGrafx-16/PC Engine Data
pce=Gerber PCE Data
pcf=Calyx Point Point Data
pcfs=Calyx Point Compressed Point Data
pcg=Autodesk Revit Point Cloud File
pdata=JSim Pretty Data Format
pdb=Brookhaven Protein DataBase
pde=Pathology Data Exchange File
pde=AFP Page Definition
pdg=Print Designer GOLD Data
pdr=Mail.dat Piece Detail File
pdtt=STK Processed Terrain File
pek=Adobe Premiere Waveform Data
pen=Corel Paint Shop Pro Pen Preset
pes=Brother Embroidery Data
pfc=Corel PercetFit Component
pfd=Personal Finances Data
pfd=Optima! 2.5 Document
pgc=PGN Game Coding
pgn=Portable Game Notation Data
pgp=PGP Security Signature/Key
pgt=Pokemon Gift File
ph=PHYLIP Format
phl=Icon Phile Scheme
pho=MBROLA Phonetic Data
phoa=PhoA Album
phr=Adobe RoboHelp Phrase List
phy=PHYLIP Format
pi=iPi Calculation Data
pigm=Indigo Packed Material Data
pj=Project64 Saved State File
pk=Adobe Audition Peak Data
pkl=Migration Wizard Packing List File
pkt=Cisco Packet Tracer Network Simulation Model
plb=Microsoft Robotics Developer Studio Playback Data
plr=Mail.dat Package Label File
ply=Polygon Model
pma=Windows NT Performance Monitor Alert File
pmc=Windows NT Performance Monitor Chart
pml=Windows NT Performance Monitor Log
pmr=Windows NT Performance Monitor Report
pms=Pegasus Mail Signature Data
pmsf=Altera Partial-Mask SRAM Object File
pmw=Windows NT Performance Monitor Workspace
pni=Popnogging Image
pnl=TopSolid Nesting Module
pns=Popnogging Subject Data
pns=Pegasus Mail Formatted Signature Data
pnt=Popnogging Theme Data
pnz=Panorama Database File Set
poc=PocoMail PocoScript
pof=Altera Programmer Object File
poi=General POI Database
polys=Ribbons Polygon Definition
pow=WAsP Power Curve
pp2=Poser Props Data
ppf=PPF-O-Matic Patch
ppi=Lifo-Pro Producer Price Index
ppz=Poser Compressed Props Data
pqt=Mail.dat Package Quantity File
prf=Microsoft Outlook Profile
pri=Migration Wizard Primary IFF File
pri=Primo Emulator Image
prj=Wavelab Workspace
prm=Tinker Parameter File
prmdc=Adobe Premiere Metadata Cache
proj=Poseidon for UML Project Information
prp=Kodak Preps Data
prs=CorelDraw Print Style
prv=Windows Previous Bootlog File
psa=Adobe Photoshop Album Catalog
psar=Sony PSP Firmware Archive
psg=AFP Page Segment Resource
psi=Affymetrix Probe Set Information
psr=PowerSoft Report
pst=Microsoft Outlook Personal Folder File
ptc=iPack Patch
ptd=Pro/ENGINEER Exported Table
ptf=Pro Tools Session Data
pth=4D Path Document
ptm=Microsoft MapPoint Map
ptn=Abbyy FineReader User Pattern
ptp=Primo Emulator Tape Image
pts=Abbyy FineReader Data
ptt=Microsoft MapPoint Template
pvm=Parallels Desktop Machine Bundle
pxd=PXLab Design
pyi=Cognos Model File
pyj=Cognos Model File
pz2=Poser Pose Data
p_b=Parasolid CAD Binary Partition Data
p_t=Parasolid CAD ASCII Partition Data
qbt=Intuit QuickBooks Temporary File
qch=Intuit Quicken for DOS Data File
qcn=QPST Content
qct=Quick Chart Data
qda=KaleidaGraph Data
qdat=QuickTime Install Cache
qdb=Quicken Data Backup
qdf=Quicken Data
qdi=Quicken Data Index
qdt=Intuit Quicken v4 Data File
qel=Quicken Electronic Library
qes=Epidata Dataform Definition
qfp=Intuit Quicken Financial Planner Data
qfx=Quicken Financial Exchange Data
qif=Quicken Interchange Format Data
qix=Intuit Quicken for DOS Index File
qld=MassLynx Quantation Data
qmd=Intuit Quicken Backup Data
qml=Intuit Quicken for DOS Memory List File
qmt=Intuit Quicken v4 Memory List File
qnx=Intuit Quicken v4 Index File
qpd=Intuit QuickPay for Windows Data
qph=Quicken Price History
qpl=KaleidaGraph Layout
qrt=QRT RayTracer Image
qsc=KaleidaGraph Script
qsd=Quicken Data
qst=KaleidaGraph Style
qst=Intuit Quicken v4 Data File
qtch=QuickTime Player Cache
qth=WinOrbit Observer Database
qtindex=Adobe Premiere QuickTime Index
qtx=QuickTime Extension
que=CuteFTP Queue Data
qw=QmailAdmin Data
qwp=Quiptics Cryptogram
qwpx=Quiptics Cryptogram
qwz=Question Writer File
ral=Atlas Right Track Layout
ral=WinRail Layout Data
rap=GSM Returned Accounts Procedure Data
rat=Nimbus 7 SAMS CRAT File
rat=PICS Service Description
rbc=Retrospect Backup Catalog
rbf=Altera Raw Binary File
rbf=RBase Data
rbt=Xilinx Raw BIT Data
rc1=Samsung S5230 Firmware RSRC1 File
rc2=Samsung S5230 Firmware RSRC2 File
rcd=Symantec pcAnywhere Recorded Session
rd=Reaction Data File
rdb=Oracle Database Root
rdf=Reaction Data File
rdo=Oracle Database Redo Log
rdx=Borland Reflex Data File
rec=Epidata Data File
rec=Windows 3.1 Macro Recorder Data
rep=Act! Report File
resp=IRIS RESP File
rfa=Autodesk Revit Family File
rfb=RoboForm Bookmark File
rfc=RoboForm Contact File
rfn=RoboForm Safenote File
rfo=RoboForm Option File
rfp=RoboForm PassCard File
rfq=RoboForm SearchCard File
rft=RoboForm Identity File
rft=Autodesk Revit Family Template
rfx=RoboForm Blocking Passcards File
rgd=Rosegarden Device Definition
rgn=Garmin Region File
rif=FRAMES Receptor Intakes File
riff=Resource Interchange File Format
rinex=Receiver Independent Exchange Format Data
rld=RecLoad Definition
rma=Rhapsody DRM License Data
rmb=RegistryMaster Data
rmf=Adobe Acrobat Rights Management
rmn=Oracle RMAN Script
rmt=Netgear Router Firmware
rnan=Nintendo Animation Resource
rnd=General Random Seed File
rom=General ROM Image
rom=NES ROM Image
rom=AMI BIOS Firmware Update
roo=Oracle CODASYL DBMS Database Root
rou=Route 66 Route Data
rpd=Oracle BI EE Repository
rpr=ArchiCAD Roof Properties
rpt=Crystal Reports Report
rrd=WAsP Roughness Description
rrr=Registry Mechanic Backup
rsd=Resort Software Database
rsd=RuneScape Demon Data
rsdb=Resort Software Database
rsdf=RapidShare Downloader Format File
rsf=WAsP Resource Data
rsm=CCNA Network Visualizer Data
rsr=Poser Model Preview
rta=Adobe RoboHelp RTA Data File
rtk=Adobe RoboHelp RTK Data File
rtm=Navicat Report File
rtp=GROMACS Residue Topology
rtree=General R-Tree Data
rts=Adobe RoboHelp RTS Data File
run=Runscanner Scan Result
rvm=AVEVA Plant Design Management System Model
rwc=WAsP Regional Wind Climate
rwd=Symphonie Logger Raw Data
s7d=Sony Ericsson S700i Phone Default Language
s7m=SAS Data Mining Database
s7s=Sony Ericsson S700i Phone Firmware
sa2=SAS Access Descriptor
sa7=SAS Access Descriptor
sac=IRIS SAC File
sad=Windows Server Security Association Database
sai=Burrows-Wheeler Alignment Tool SAI Data
sas7bacs=SAS Access Descriptor
sas7baud=SAS Audit Data
sas7bbak=SAS Backup
sas7bcat=SAS Catalog
sas7bdat=SAS Data Set
sas7bdmd=SAS Data Mining Database
sas7bfdb=SAS Consolidation Database
sas7bitm=SAS Item Storage
sas7bmdb=SAS Multi-dimensional Database
sas7bndx=SAS Index
sas7bvew=SAS Index
sat=Standard ACIS Text
sav=General Saved Data
sav=SPSS Data
sb7=SAS Backup
sbc=Microsoft Accounting Company Data
sbd=Microsoft Accounting Data
sbe=SpyBot Search and Destroy Exclude Data
sbi=SpyBot Search and Destroy Database
sbj=z-Tree Subject
sbk=SWiSH Max Backup Data
sbl=Microsoft Accounting Server Log
sbs=SpyBot Search and Destroy Include
sc2=SAS Catalog
sc7=SAS Catalog
sch=Microsoft SQL Server Data Replication Schema
schdoc=Altium Designer Schematic File
sco=Microsoft IIS Schema Backup
scp=SCP-ECG Data
scs=StuffIt Saved File List
sd2=SAS Data Set
sd7=SAS Data Set
sdf=Microsoft SQL Server Database
sdl=SmartDraw Library
sdl=Suunto Dive Log
sdts=Spatial Data Transfer Standard File
sdv=WDK Static Driver Verifier Rules
sec=Migration Wizard Secondary IFF File
seg=Mail.dat Segment File
segy=SEG Y Data File
sep=SimEnhancer Profile
seq=Tinker Sequence
ses=Adobe Audition Session
sew=Janome Stitch-based Embroidery Data
sf2=SAS Consolidation Database
sf7=SAS Consolidation Database
sfc=SNES ROM Image SMC
sfcache=Windows Vista RedayBoost File
sfp=System File Protection Database
sfr=Mail.dat Special Fees File
sft=Microsoft App-V Application
sfx=StatGraphics Centurion Data
sgb=Songsheet Generator Songbook
sha=SHA-1 Checksum
sha1=SHA-1 Checksum
shb=Windows Shell Scrap Object
shc=Adobe Photoshop Shape Curves
shd=Windows Shadow Header
shh=Adobe Photoshop Shadow and Highlight Data
si2=SAS Index
si7=SAS Index
siard=SIARD Database Archive
sid=Steam Game Backup Data
sim=Steam Game Backup Metadata
sim=Simile Model
sin=Xperia X10 Phone SIN Firmware
sis=Steam Game Backup Info
skn=Windows Automotive Skin
skypeemoticonset=Skype Emoticon Pack
slb=Multiframe Sections Library
sldasm=SolidWorks Assembly Document
sldpart=SolidWorks Part Document
sldprt=SolidWorks Part Document
slk=Symbolic Link Spreadsheet
slt=ZX Spectrum Emulator Snapshot SLT
sm2=SAS Multi-dimensional Database
sm7=SAS Multi-dimensional Database
smb=Autodesk Mapguide Symbol Library
smc=SNES ROM Image SMC
smd=Sega Genesis ROM
sml=Simile Model
sms=My Phone Explorer SMS
smt=Apollo HiPer-SIx Database Memo
smx=SysMetrix Skin
sn1=Drive Snapshot Backup Data
sn2=Drive Snapshot Backup Data
sn3=Drive Snapshot Backup Data
sn4=Drive Snapshot Backup Data
sn5=Drive Snapshot Backup Data
sn6=Drive Snapshot Backup Data
sn7=Drive Snapshot Backup Data
sn8=Drive Snapshot Backup Data
sn9=Drive Snapshot Backup Data
sna=ZX Spectrum Emulator Snapshot SNA
sna=Drive Snapshot Backup Data
snes=SNES ROM Image
snm=Netscape Mail Index
snr=Mail.dat Seed Name File
sns=Save-N-Sync Profile
snx=ZX Spectrum Emulator Snapshot Extended
sof=Altera SRAM Object File
sol=Adobe Flash Player Shared Object
sor=Adobe Flash Media Server Client Side Shared Object
sp=SignPlot Document
spa=MikuMikuDance Sphere Mapping File
spc=Thermo Scientific SPC File
spd=SpecTRM Specification
spd=Windows Server Security Policy Database
spdb=iGO Primo SpeedCam Database
spf=SQR Portable Format
spg=SG TCP Optimizer Backup
sph=Ribbons Sphere Definition
spl=Windows Spool Data
spm=Nanoeducator File
spo=SPSS Statistical Output
spr=ArchiCAD Slab Properties
sps=SPSS Syntax File
spud=iGO Primo SpeedCam Database Update
sqb=SQL Backup SQL Server Backup
sql=SQL Script
sqlite=SQLite Database
sqm=Microsoft Message Queuing Data
sqs=SQL Script Sequences
sr7=SAS Item Storage
srd=Summary Record Database
srm=SNES Save State File
srs=Microsoft Outlook Send/Receive Settings
ss=Ribbons Secondary Structure
ssd=Stardock WindowBlinds Skin Filelist
sss=Stardock WindowsBlinds Substyles
sst=Microsoft Serialized Certificate Store
ssw=Sony-Ericsson Firmware
st2=SAS Audit Data
st7=SAS Audit Data
sta=Adobe Photoshop CS Color Statistics
startupinfo=E-Prime StartupInfo File
stg=Microsoft ActiveSync Mobile Device Backup
sth=Lotus Domino Stash File
stip=SampleTank 2 Instruments Preset
stk=Stickfigure Animator File
stl=Macromedia Fireworks Style Library
stm=Microsoft Exchange Streaming Media File
stm=Nanoeducator File
str=dBASE Structure Object
sts=AdriPSX Save State
sts=Nimbus 7 SAMS Status Data
stt=Streets & Trips Map Template
stv=SofTV Author File
stx=SAS XPORT Transport File
sud=Super Project Data
sup=Super Project Definition File
sur=Topocad Survey Data
surf=V_sim Surface Data
sv$=Autodesk AutoCAD Automatic Save File
sv2=SAS Index
sv2i=Symantec System Index
sv7=SAS Index
svd=Alchemex Metadata
svw=SpecView Data
swb=SolidWorks Older Macro
swc=SNES ROM Image SWC
swp=General Swap File
swp=SolidWorks Macro
sxt=Formula Graphics Script
syn=TextPad Syntax File
sys=Microsoft SQL Server Data Replication System Table Data
sys=General Swap File
syx=MIDI System Exclusive Message
sy_=Compressed SYS File
t00=TaxCut Federal Data
t01=TaxCut Federal Data
t02=TaxCut Federal Data
t03=TaxCut Federal Data
t04=TaxCut Federal Data
t05=TaxCut Federal Data
t06=TaxCut Federal Data
t07=TaxCut Federal Data
t08=TaxCut Federal Data
t09=TaxCut Federal Data
t99=TaxCut Federal Data
tab=SQL Script Tables
tad=TA Orchestrator Data
taf=ADRIFT Text Adventure File
tag=DataFlex Query Tag
tap=ZX Spectrum Emulator Tape Data TAP
tap=GSM Transferred Account Procedure Data
tax=Intuit TurboTax Data
tb0=Adobe Photoshop Thumbnail Cache
tbl=Pro/ENGINEER Table
tbl=ArcVIEW Geocode Support Table
tbu=Passolo Translation Bundle
tbv=Turbo-BrainVoyager Data
tcf=Topocad Camber Diagram
tcs=Topocad Cross Sections
tdb=SlamDB Database
tdf=Guide Text Definition File
tdf=DVD X Copy TDF File
tdo=Xilinx Text Design Output
tdt=THOR Datatree File
tek=Tektronix HEX Data
th=Therion Data
th2=Therion TH2 Map
theme=Microsoft Windows Desktop Theme
tic=ArcInfo Coverage TIC
tin=WMS Triangulated Irregular Networks Data
tit=CXTerm Text Input Table
tji=TaskJuggler Include File
tjp=TaskJuggler Project File
tk1=Wintec WBT-201 TK1 Tracklog
tk2=Wintec WBT-201 TK2 Tracklog
tk3=Wintec WBT-201 TK3 Tracklog
tk4=Wintec WSG-1000 Mark Database
tlf=Timing Library Format File
tlx=CuteSITE Builder Website Data
tme=Bryce Time Data
tmm=TimeMap Metadata
tmw=Translation Memory Data
tna=Topocad Net Adjustment
tnef=Transport Neutral Encapsulation Format
toc=Eudora Addressbook TOC
top=GROMACS System Topology
tot=LG Phone Rom
tpa=GROMACS ASCII Input File
tpb=GROMACS Binary Input File
tpf=Topocad Profile Form
tpr=GROMACS Portable Binary Input File
tps=Clarion TopSpeed Database
tra=WinTrack Railroad Track
trd=TrID Definitions Package
trf=LFToolkit Transformation Rules File
trg=SQL Script Triggers
tri=Ribbons Triangle Definition
trk=Garmin GPS PCX5 Tracklog
trl=Topocad Roadlines
trl=Holux GM-101 Tracklog
trn=Microsoft SQL Server Transaction Log
trp=Topocad Road Profile
trp=TripMaker Document
trs=TrIDNet Serialized Definitions Package
trs=Table Retrieval System Document
trt=Team Sports Scheduling System Report Template
trv=Topocad Traverse Document
tsg=TSG Data
tsk=Task Coach Data
tst=Topocad Section Template
ttf=Altera Tabular Text File
ttl=Tera Term Macro
ttx=Trados TagEditor File
tuf=Microsoft SQL Server Transaction Undo File
tvgskin=TVgenial Skin
tvp=Nvidia NView Desktop Profile
twb=Tableau Workbook
twbx=Tableau Packaged Workbook
tx=TX Text Control Data
txf=TurboTax Tax Exchange Format
txn=SAP POS TXN Log File
tx_=Compressed TXT File
tzx=ZX Spectrum Emulator Tape Data TZX
ucd=AVS Unstructured Cell Data
uce=Microsoft Windows Unicode Extensions Data
ucf=User Constraints File
uci=UFS Explorer Compressed Image
ucs=F5 User Configuration Set
udb=Microsoft Dynamics AX User Database
udc=Adobe InDesign User Dictionary
udf=Windows NT Uniqueness Database File
udl=MDAC Universal Data Link
uef=Unified Emulator Format
ufi=User Flash Image
ufo=SNES ROM Image UFO
uis=Stardock WindowsBlinds Style Description
ulf=UMX Language File
unl=Garmin Unlock Key
unt=Autodesk AutoCAD Unit Definition
unv=I-DEAS UNV File
upd=Program Update Information
upoi=iGO 2008 POI Database
urd=Ultra Recall Database
user=Unix Filesystem User Quota Data
usr=Pegasus Mail User Data
uss=WinUAE Saved State
utf=AOL Software Update
uu=Uuencoded Data
uue=Uuencoded Data
v=Vivid 2.0 Input File
v3d=Visual3D.NET Data
v64=N64 ROM Image Doctor V64
vac=Vocaloid Accessory File
vb=Virtual Boy ROM
vbd=Visual Basic ActiveX Document
vc=Vivid 2.0 Color Definition
vdb=Norton Antivirus Virus Database
vdr=VirtualDub Frame-Server Data
vfa=VentaFax Remote Control Script
vfs=Virtual File System Index
vfs=VentaFax Schedule Data
vgp=Vectir Profile Group File
vim=Vim Script
vis=AMPAC Visualization File
vld=DataFlex Compressed Database
vlg=VentaFax Log Book
vlt=VLC Media Player Skin
vna=NetDraw Dataset
vo=Vivid 2.0 Object Definition
vqd=VisiQuick Data
vrg=Visual Studio SDK Package Registry Data
vrp=Vectir Remote Profile File
vs=Vivid 2.0 Include
vsf=VICE Snapshot File
vsl=Microsoft Visio Library
vsv=Virtual Machine Saved State
vtd=Microsoft VOLT Glyph Data
vts=VTK XML Structured Grid Data
vu=XtalView VU Object
vud=Virtual Undo Disk File
vue=Vue Scene File
vvd=Minolta Vivid 3D Scanner Element
wab=Windows Address Book Data
wal=WinAMP Skin
wba=WindowsBlinds Skin
wbc=Webshots Image Collection
wbcat=Windows Backup Catalog
wbd=Softlink Whiteboard
wbd=eBeam Whiteboard
wc=Total Commander Directory Tree
wca=WinCatalog Standard Database
wcat=WinCatalog Standard Database
wcf=FRAMES Water Concentration File
wcl=WinCatalog Light Database
wcs=WhopSee Compressed Skin
wcz=Chameleon Clock Wallpaper
webarchive=Safari Web Archive
wff=Dataplore Wavelet Filter
wff=FRAMES Water Flux File
wfm=Tektronix Oscilloscope Waveform Data
wft=Oracle Workflow Process Definition
wid=Microsoft Sharepoint Document Set Index
wid=Corel Ventura 4 Width Table
win=Opera Saved Session
wings=Wings 3D Mesh
wir=Mentor Expedition PCB Tool Data
wixlib=Windows Installer XML Library
wm3=MSC.visualNastran 4D Model
wmi=WorlMate Itinerary Data
wnd=Farsite Wind Data
wog=WAsP Obstacle Group
wov=Cakewalk Sonar Picture Cache
wpi=OS/2 WarpIN Installer
wpk=Corel WordPerfect Keyboard Layout
wpo=Holux GM-101 Waypoint
wpr=Holux GM-101 Route
wrg=WAsP Resource Grid
wrr=WAsP Roughness Rose Data
wrt=WhistlerMap Waypoints Data
wsad=OpenEdge Web Services Application Descriptor
wsb=Microsoft Sharepoint Document Set
wsg=WAsP Site Location Data
wsr=Mail.dat Walk Sequence File
wsstyles=Windows Sidebar Styler Style
wsw=WebSite-Watcher Bookmark List
wsz=WinAMP Skin
wtf=WinTaper Data File
wtg=WAsP Wind Turbine Generator Data
wtk=WinTalk URL
wtr=Farsite Weather Data
wts=WebPlus Theme Set
wup=WhatsUp Gold Network Map
wvf=Yokogawa Waveform Data
wvm=Ricardo WAVE Input
wwf=WAsP Wind Farm Data
wwh=WAsP Workspace
xaf=IMVU Animation
xas=Pro/ENGINEER XAS File
xcs=TBX eXtensible Constraint Specification
xdb=Norton Antivirus Update
xdf=TunerPro Definition File
xdl=Expert Definition Language Document
xft=Adobe Form Designer XML Form Template
xix=Microsoft IIS NNTP Subject Lists
xle=XML Cooktop File
xli=3D Studio Max IGES Input Log
xlo=3D Studio Max IGES Output Log
xlo=Autodesk Inventor Export Journal
xmbl=Vernier Logger Pro Data
xme=GME Metamodel
xmf=IMVU 3D Model
xmlz=ZennoPoster MP Template Data
xmod=Monarch Pro Model
xmp_bin=Parasolid CAD Binary Partition Data
xmp_txt=Parasolid CAD ASCII Partition Data
xmt_bin=Parasolid CAD Binary Parts Data
xmt_txt=Parasolid CAD ASCII Parts Data
xmx=Autodesk AutoCAD External Message File
xpd=PlayStation Network Downloader Data
xpf=IMVU Morph Data
xpo=Microsoft Dynamics AX Export
xpr=Pro/ENGINEER XPR File
xrf=IMVU Material File
xri=XML for Requirements Interchange Data
xrm-ms=Windows Vista Activation Certificate
xs=Hummingbird Exceed Startup File
xsf=IMVU Skeleton Data
xsi=Softimage dotXSI 3D Model
xtm=XtremSplit Data
xtp=XTree Data
xtp=XTrkCAD Layout
xtpl=XER Manager Template
xtr=XTrkCad Demo
xvg=Grace Document
xx=Xxencoded Data
xxe=Xxencoded Data
xxx=Singer XL Embroidery Data
xyz=Tinker Cartesian Coordinates
xzp=Freestyle Dash Skin
x_b=Parasolid CAD Binary Parts Data
x_t=Parasolid CAD ASCII Parts Data
ytr=IRIS OCR Data
z64=N64 ROM Image Mr. Backup Z64
z80=ZX Spectrum Emulator Snapshot Z80
zbd=Canon ZoomBrowser EX Database
zfo=602XML Filler Form Data
zid=ZooImage Data
zis=ZooImage Series Description
zix=Quicken Data
zmc=ZoneAlarm Quarantine
zot=Zoot Information Processor Database
zprj=ArcSoft Print Creations Template
zs0=ZSNES Save State
zs1=ZSNES Save State
zs2=ZSNES Save State
zs3=ZSNES Save State
zs4=ZSNES Save State
zs5=ZSNES Save State
zs6=ZSNES Save State
zs7=ZSNES Save State
zs8=ZSNES Save State
zs9=ZSNES Save State
zst=ZSNES Save State File
zth=DivX Connected Theme
zx=KGB ZX Spectrum Emulator Snapshot
zx82=Speculator 97 Snapshot
zxs=ZX Spectrum Emulator Snapshot ZXS
zzs=MultiView Script