a3l=Macromedia Authorware Library
a3m=Macromedia Authorware Macintosh File
a3w=Macromedia Authorware Windows File
a4l=Macromedia Authorware Library
a4m=Macromedia Authorware Macintosh File
a4p=Macromedia Authorware Source
a4w=Macromedia Authorware Windows File
a5l=Macromedia Authorware Library
a5m=Macromedia Authorware Macintosh File
a5p=Macromedia Authorware Source
a5w=Macromedia Authorware Windows File
a5w=Alpha Five Web Publishing File
a5wcmp=Alpha Five Web Publishing Component
a6l=Macromedia Authorware Library
a6m=Macromedia Authorware Macintosh File
a6p=Macromedia Authorware Source
a6w=Macromedia Authorware Windows File
a7e=Macromedia Authorware Packaged Library
a7l=Macromedia Authorware Library
a7m=Macromedia Authorware Macintosh File
a7p=Macromedia Authorware Source
a7w=Macromedia Authorware Windows File
ab=Applix Builder File
ab2=Blitz Basic Code
ac=GNU Autoconf Input File
ad=DSM Application Diagram
adb=Alpha Five Database
adb=Ada Implementation File
adblock=Alpha Five Database Lock
ads=Ada Specification File
aex=Alpha Five Compiled Library Script
aio=APL Transfer Format File
alb=Alpha Five Library
alm=Alpha Five Data
alx=Alpha Five Script Data
am=GNU Automake Input File
ani=Valve Source Model Animation Data
anv=Anastasia Style
ap=WebSuite Active Page
app=Visual FoxPro Application
aps=VS Binary Resource Script Data
apx=WebSuite Compiled Active Page
arq=Remedy ARS Macro
arsc=Android Package Resource
as=Flash ActionScript
asa=ASP Global Script
asax=ASP.NET Application
ascx=ASP.NET User Controls
ashx=ASP.NET HTTP Handler
asi=Alpha Five Variables Data
asm=Assembly Source
asmx=ASP.NET Web Service
asp=Active Server Page
aspx=ASP.NET Page
asr=Flash Server-side ActionScript
asv=MATLAB AutoSave File
asx=Alpha Five Database Index
au3=AutoIt v3 Script
avm=QAvimator Document
awk=AWK Script
awl=Siemens AWL File
axd=ASP.NET Trace Handler
axe=Annotated XML Example
b2d=Brutus2D Source Code
b3d=Blitz3D Data
bb=GCOV BB Data FIle
bb=Blitz Basic Code
bb2=Blitz Basic Code
bbg=GCOV BBG Data FIle
bdt=TAC Script
bdx=VisionICE Flat Binary Downloadable
bin=Windows CE Emulator Image
blk=ProWorx NXT Block Data File
bpg=Borland Project Group
bpi=Borland Package Import
bpk=Borland Package
bpl=Borland Package Library
bsc=Visual Studio Browser Information
bvh=Biovision Hierarchy Data
c=C Source Code
c++=C++ Source Code
cbl=COBOL Source Code
cc=C++ Source Code
cco=CodeCheck Object File
ccp=CodeCharge Studio Page
cdt=ProWorx NXT Temporary Long Comment Data
cdx=Alpha Five Table Index
cem=Windows CE Emulator Image
cfc=ColdFusion Component File
cfm=ColdFusion Markup Language
cfml=ColdFusion Markup Language
cgf=ProWorx NXT Codegen Batch
cgi=RAD Studio CodeGuard Configuration
cgl=RAD Studio CodeGuard Log
cgr=Quest3D Application
chi=C To Haskell Interface File
chs=Haskell Source With C Hooks
clb=Code Librarian Database
clog=MPI Parallel Environment CLOG
cls=Visual Basic Class Module
clw=Visual Studio ClassWizard Data
cml=ProWorx NXT Comment Data
cof=MPLAB IDE COF File
cof=Common Object File
cpb=CPB Data
cpf=Cab Provisioning Format
cpk=Novell Netware Compiled Server Software Package
cplusplus=C++ Source Code
cpp=C++ Source Code
cr=CRiSP Macro File
cr1=CRBasic Source
cr2=CRBasic Source
cr3=CRBasic Source
cr4=CRBasic Source
cr5=CRBasic Source
cr6=CRBasic Source
cr7=CRBasic Source
cr8=CRBasic Source
cr9=CRBasic Source
crf=MASM Cross-Reference Data
cs=Visual C# .NET Class
cshtml=Razor C# Web Page
csm=C++ Builder Precompiled Header
ctf=MATLAB Component Technology File
ctl=Visual Basic User Control Text
ctrl=Oracle WebLogic Workshop Controls
ctx=Visual Basic User Control Binary File
cvsignore=CVS Ignore File
cxx=C++ Source Code
d=D Source Code
da=Gcov Data File
dad=RemObjects Delphi Data Abstract Driver
dbg=Microsoft Visual Studio Debug File
dbgdt=IAR System Debugger Desktop Data
dbi=Database Explorer Information
dcf=ProWorx NXT Database Configuration
dci=RAD Studio Delphi Code Insight
dcp=Delphi Component Package
dcr=Delphi Component Resource
dct=Delphi Component Template
dcu=Delphi Compiled Unit
ddb=ProWorx NXT Descriptor Data with Blocking
ddd=Alpha Five Data Dictionary
ddf=Diamond Directive File
ddf=ProWorx NXT Descfriptor Data File
ddl=Data Definition Language File
ddm=Alpha Five Data Dictionary Memo
ddx=Alpha Five Data Dictionary Index
def=C++ Definition File
dem=Delphi Edit Mask
dep=Visual Studio Package and Deployment Wizard Dependency File
deployproj=RAD Studio Deployment Manager Configuration
dex=Android Compiled Executable
df=OpenEdge ABL Data Definition
dfd=ABC Dyadic Functions Data
dfm=Delphi Form
dif=ProWorx NXT Data Interchange File
din=DataEase Installation Script
disco=Visual Studio .NET Discovery Data
dlg=Visual C++ Dialog
dm=BYOND Dream Maker Source Code
dmb=BYOND Dream Maker Compiled World
dmd=Domain Model Definition
dmm=BYOND Dream Maker Map
dmt=Delphi Menu Template
dmx=Microsoft SQL Server Data Mining Extension
do=Stata Batch File
dob=Visual Basic ActiveX Document Form
dof=Delphi Option File
dox=Visual Basic ActiveX Document Binary Form
dpb=ProWorx NXT Descriptor Pointer with Blocking
dpf=ProWorx NXT Descfriptor Pointer File
dpk=Delphi Package
dpl=Delphi Package Library
drc=Delphi Resource Strings
dres=Delphi Compiled Resource
dro=Delphi Repository Object
ds=DAZ Studio ASCII Script
dsa=DAZ Studio ASCII Script
dsb=DAZ Studio Binary Script
dse=DAZ Studio Script Encrypted
dsf=ProWorx NXT Data Setup File
dso=SymbianOS Dynamic Shared Object
dsr=Visual Basic Designer File
dsu=ProWorx NXT Data Setup File
dsw=Microsoft Developer Studio Workspace
dsx=Visual Basic Designer Binary File
dsym=Xcode Debugging Symbols
dta=Stata Data File
dtb=Linux Device Tree Blob
dts=Linux Device Tree Source
dump=Library Symbols Data
dvb=Autodesk AutoCAD VBA Macro
dws=Visual Studio Deployment Wizard Script
e=Euphoria Include File
e=E Source Code
ec=Informix ESQL/C Source
ece=Escenic Content Engine Dynamic Page
elb=Synergy/DE Executable Library
erb=Ruby ERB Script
eu=Euphoria Include File
ew=Euphoria Include File
ewd=IAR System Debugger Data
eww=IAR System Workspace Data
ex=Euphoria Source Code
ex4=MQL4 Compiled Modules
ext=Visual Studio .NET DB Project Extended Properties
exu=Euphoria Source Code
exw=Euphoria Source Code
f=Fortran Source Code
f77=Fortran Source Code
f90=Fortran Source Code
fbap=FinalBuilder Action Package
fbl5=FinalBuilder Project Log
fbl6=FinalBuilder Project Log
fbpinf=FinalBuilder Project Info
fbv=FinalBuilder Persistent Variables File
fd=Fortran Declaration File
fda=FlashDevelop Argument File
fdb=FlashDevelop Binary File
fdl=FlashDevelop Layout File
fdm=FlashDevelop Macro
fdt=FlashDevelop Template
fdz=FlashDevelop Zip File
fi=Fortran Interface File
fic=WinDev HyperFileSQL Database
fig=MATLAB Figure
fil=ProWorx NXT Format Export
fla=Shockwave Flash Source File
flash=Shockwave Flash Source File
fll=Visual FoxPro DLL
flm=Flasm Disassembled SWF
fly=Fly Script
fmb=Oracle Forms Form Module Binary
fmt=Oracle Forms Form Module Text
fmx=Oracle Forms Form Module Executable
for=Fortran Source Code
form=Gambas V2 Form
fox=FoxBase Compiled Executable
fpa=Front Panel Express Order Data
fpd=Front Panel Express Design
fpt=Visual FoxPro Memo
frg=DBase IV Uncompiled Report
frm=Visual Basic Form
frt=Visual FoxPro Report Memo
frx=Visual FoxPro Report
fsb=Form Z Compiled Script
fsl=Form Z Script
fsq=CryENGINE Facial Editor Sequence
ftn=Fortran Source Code
ftx=WinDev HyperFileSQL Full-text Index
fx=Microsoft DirectX D3D Effect
fxp=Visual FoxPro Compiled Program
gab=WinDev Skin Template
gambas=Gambas V2 Application
gas=Atari Jaguar GPU Assembly Source
gbl=Visual Basic Global Declaration
gcda=Gcov Data File
gcno=Gcov Metadata File
gcov=GNU GCOV Logfile
gdb=Interbase Database File
gdt=Graph Drawing Toolkit Output
gld=MPLAB C Compiler Linker Script
glo=Visual Basic Global Declaration
gph=Stata Graph File
gpi=GNU Pascal Interface.
gs=Gofer Source Code
h=C Header File
hdmp=Windows Heap Dump
hh=C++ Header File
hhc=HTML Help Table of Contents
hhk=HTML Help Index
hic=HicEst Script
hm=WinHelp Context ID
hpp=C++ Header File
hs=Haskell Source
hsp=WinDev HyperFileSQL Stored Procedure
htl=HTL Source
htp=htp Source File
hxa=MS Help 2 Project Attribute Definition
hxc=MS Help 2 Project Collection Definition
hxe=MS Help 2 Project Sample Definition
hxf=MS Help 2 Project Include File
hxk=MS Help 2 Project Index
hxt=MS Help 2 Project ToC
hxv=MS Help 2 Project Virtual Topic Definition
hxx=C++ Header File
i=Visual C++ Preprocessed Source
i=INTERCAL Source File
i3=Modula-3 Interface
icf=Implementation Configuration File
icp=Remote Call Profiler Data
ida=Internet Data Administration Script
idl=Interface Definition File
idml=Adobe InDesign Markup Language Document
idt=Windows Installer Exported Database
ifm=IBM WebSphere Interface Mapping
il=Cadence SKILL File
ile=Encrypted Cadence SKILL File
ilk=Visual Studio Incremental Link File
iml=IntelliJ IDEA Module
inc=ASP Include File
inc=General Include File
int=Delphi Interface Unit
isd=InstallShield Dialog
isl=InstallShield Pro Log
isn=InstallShield Skin
iss=InstallShield Response File
iws=IntelliJ IDEA Workspace
j=Java Source Code
jasper=JasperReports Compiled JRXML File
java=Java Source Code
joy=CryENGINE Facial Editor Joystick Settings
jrxml=JasperReports Document
js=Java Source Code
jsa=JRun Server Application
jsb=JavaScript Bean
jsp=Java Servlet
jspx=Java Servlet XML
jsx=Adobe ExtendScript File
jsxbin=Adobe ExtendScript Binary File
jws=Java Web Service
kci=Visual Studio .NET DB Project Indexing Options
ko=Linux 2.6 Kernel Object
kof=Kylix Options File
kpz=Komodo IDE Compressed Package
ksh=KSH Shell Script
ldf=ProWorx NXT Logic Data File
lfm=Lazarus Form
lgf=ProWorx NXT Log Book Note
lgt=Logtalk Source Code
lib=Visual C++ Import Library
lib=ESPL Encrypted Programming File
llb=LabVIEW Library
llx=LabVIEW Virtual Instrument Library Backup
lpb=ProWorx NXT Logic Pointer with Blocking
lpf=ProWorx NXT Logic Data File
lpi=Lazarus Project Information
lpr=Lazarus Program Source
lproj=Language Project Folder
lps=Lazarus Project Session
lrs=Lazarus Resource
lsp=Lisp Source Code
lss=LotusScript Source Code
lua=LUA Source Code
lvm=LabVIEW Measurement
m=MATLAB Script
m1s=Mach3 Macro
m3=Modula-3 Source Code
m4=M4 Macro File
mak=Visual Studio Makefile
make=Xcode Make File
manifest=Java Manifest File
master=ASP.NET Master Page
mat=MATLAB Matrix
mc=Sendmail M4 Configuration Source
mcw=MPLAB IDE Workspace
mdb=ProWorx NXT Memory Data with Blocking
mdf=ProWorx NXT Memory Data File
mdl=Valve Source Model Data
mdmp=Windows Debug Dump
mdp=Microsoft Developer Studio Project
mdx=Multidimensional Expressions Script
mel=Autodesk Maya Embedded Language Script
mex=MATLAB Executable
mf=Java Manifest File
mfd=ABC Monadic Functions Data
mfl=Localized Managed Object Format File
mft=Java Manifest File
mfx=Multimedia Fusion Extension
miz=Mizar Article
mk=GNU Makefile
mlb=FoxPro 2 for Macintosh Library
mlib=MATLAB Shared Library
mlv=LabVIEW Mathscript
mmb=Oracle Forms Menu Module Binary
mmo=WinDev HyperFileSQL Memo File
mmt=Oracle Forms Menu Module Text
mmx=Oracle Forms Menu Module Executable
mnt=Visual FoxPro Menu Memo
mnx=Visual FoxPro Menu Template
mo=GNU gettext Machine Object File
mobileprovision=Provisioning Profile
mof=Managed Object Format File
mpr=Visual FoxPro Menu Program
mpx=Visual FoxPro Compiled Menu Program
mpx=Alpha Five Temporary Index
mq4=MetaQuotes Language 4 Source Code
msb=Oracle Binary Message File
msl=ProWorx NXT MSL Loadable
mspx=Microsoft Presentation Framework Page
mu=MuPAD Source Code
muf=Alpha Five Concurrent Users Data
mui=Multilingual User Interface Data
mv=Miva Script Source Code
mvc=Compiled Miva Script Program
mxml=Adobe Flex Markup Language
n=Neko Bytecode
ncb=Visual Studio No Compile Browse File
ndb=ProWorx NXT Short Comment with Blocking
ndf=ProWorx NXT Short Comment File
ndx=WinDev HyperFileSQL Index
neko=Neko Source Code
nib=Apple Interface Builder Resources
nvb=NVSG SDK Scene Graph
o=Compiled Object File
obe=Objeck Executable File
obl=Objeck Compiled Library
obs=Objeck Source Code
oca=Visual Basic Control TypeLib Cache
oem=Windows OEM Setup File
ohc=Borland OpenHelp Contents
ohi=Borland OpenHelp Index
ohl=Borland OpenHelp Links
olb=Synergy/DE Object Library
olb=Oracle Forms Object Library Module Binary
ole=Object Linking and Embedding Data
olt=Oracle Forms Object Library Module Text
opf=Obsidium Project File
opt=Microsoft Visual Studio Workspace Options
opt=ProWorx NXT List Module Option File
osd=Open Software Description File
p=MATLAB Compiled Program
pag=Visual Basic Property Page File
page=HybridJava Web Page
pas=Pascal/Delphi Source Code
pas=FreePascal Source Code
pbd=Sybase PowerBuilder Runtime Library
pbg=Adobe Pixel Bender Graph
pbi=Microsoft Profiler Binary Input
pbj=Adobe Pixel Bender Bytecode
pbk=Adobe Pixel Bender Kernel
pbl=Sybase PowerBuilder Source Code Library
pbo=Microsoft Profiler Binary Output
pbr=Sybase PowerBuilder Resource Library
pbt=Microsoft Profiler Binary Table
pcf=RISCWatch Processor Configuration File
pch=Visual Studio Precompiled Header
pcp=Patch Creation Properties File
pdb=Visual Studio Program Database
pdl=Policy Description Language File
pdm=Visual Basic PDW Script
pds=PLDasm Source
per=PEX Report
perl=Perl Script
pgx=Visual Basic Binary Property Page File
phar=PHP Archive
phd=Portable Heap Dump
php=PHP Script
php3=PHP Script
php4=PHP Script
php5=PHP Script
phps=PHP Script
phtml=PHP Script
phy=Valve Source Collision Model Data
pi4=Robolab Pilot 4 Program
pi5=GEMPIE Print File
pjm=Visual FoxPro Project Metafile
pjt=Visual FoxPro Project Memo
pkb=Oracle Package Body
pko=Packo Package
pks=Oracle Package Specification
pl=Perl Script
plc=PL/B Source Code
pld=Oracle PLD Library
pli=PL/I Source Code
pll=Oracle PLL Library
plx=Oracle PLX Library
pm=Perl Module
po=GNU Gettext Portable Object
pod=Perl POD Document
pom=Apache Maven Build
pp=FreePascal Source Code
ppl=FreePascal Shared Library
ppu=FreePascal Compiled Unit
prc=Visual Studio .NET DB Project Stored Procedure
prd=RISCWatch Processor Resource Definition
prg=Visual FoxPro Program
prl=Perl Script
properties=Java Properties File
props=Visual Studio Property Sheet
ps1=Windows PowerShell Script
psl=PowerTerm Power Script
pth=Python Path Configuration
ptl=IBM Rational Rose Petal File
ptm=Portable Translation Memories
pvti=ParaView VTK Parallel Image Data
pvtp=ParaView VTK Parallel Poly Data
pvtr=ParaView VTK Parallel Rectilinear Grid
pvts=ParaView VTK Parallel Structured Grid
pvtu=ParaView VTK Parallel Unstructured Grid
pwn=Pawn Source Code
pxd=Pyrex Definition File
py=Python Script
pyf=F2PY Signature File
pym=Python Macro File
pyo=Python Optimized Code
pyr=Python Repository
pyw=Python Script
pyx=Pyrex Source
qcf=QuickBasic Coordinates File
qpr=Visual FoxPro Query Program
qrc=QT Resource Collection File
qrp=QuickReport Data
qss=QT Style Sheet
qx=Quexal Source Code
qx=Quex Input File
r=R Source Code
r=Pegasus Mail Resource File
rap=RAPTOR Data
rb=RealBasic Source Code
rb=Ruby Console Application
rbc=Rembo-C Script Source
rbw=Ruby Windowed Application
rbx=Rembo-C Compiled Executable
rc=Visual Studio Resource Script
rc2=Visual Studio RC2 Resource
rct=VS Resource Script Template
rdata=R Workspace
rdf=ProWorx NXT Cross-reference Data
rdlc=Visual Studio Client Report Definition Document
rep=WinDev HyperFileSQL REP File
res=Windows Resource File
resources=Visual Studio .NET Resources Data
resx=ASP.NET Resource
rgs=Windows Registration Script
rhtml=eRuby HTML Web Page
rjs=Ruby Javascript
rll=Microsoft Resource Library
rms=Java Application Settings
rmuf=Alpha Five Runtime Users Data
rpf=ProWorx NXT Cross-reference Pointer
rpp=RPP Script
rpp=SymbianOS Pre-processed Resource
rsc=Pegasus Mail Compiled Resource
rsg=SymbianOS Resource Header
rsi=Reactis Info File
rsl=Robot Scripting Language
rsp=MSBuild Response File
rsrc=Mac OS X Resource Data
ruf=ProWorx NXT Address Used Tables Reference
rul=InstallShield Install Script
rvb=Rhino 3D Visual Basic Script
s=Assembly Source
s7p=STEP 7 Program
sac=Single Assignment C Code
sas=SAS Program
sas7bpgm=SAS Stored Program
sas7bput=SAS Permanent Utility
sas7butl=SAS Utility
sbr=Visual Studio Source Browser Data
sca=Scala InfoChannel Script
scala=Scala Source Code
scb=Scala InfoChannel Published Script
scc=Visual SourceSafe File
scpt=AppleScript Script
scx=Microsoft Visual FoxPro Form
sdm=System Definition Model
sem=Alpha Five Set Object
servoy=Servoy Archive
set=Alpha Five Set Data Dictionary
sex=Alpha Five Set Index
sexi=Alpha Five Set Index
sh=Unix Shell Script
sitemap=ASP.NET Site Map
sl4=GEMPACK Solution File
sln=Microsoft Visual Studio Solution
snippet=Visual Studio IntelliSense Code Snippet
snk=.NET Strong Name Key
so=Unix Shared Library
sp2=SAS Permanent Utility
sp7=SAS Permanent Utility
spk=Novell Netware Server Source Package
spr=Visual FoxPro Form Program
spt=ESPL Programming File
sqo=Squeak Object
src=ProWorx NXT Search Data
src=General Source Code File
ss2=SAS Stored Program
ss7=SAS Stored Program
ssc=Visual SourceSafe Status File
stp=HTML Help Stop Words
stp=Microsoft Sharepoint Site Template
sts=Squeak Source Code
su2=SAS Utility
su7=SAS Utility
sum=Stata Checksum File
suo=Visual Studio Solution User Options
svc=Microsoft IIS Special Content File
svn-base=Subversion Base Data
svn-work=Subversion Cache
swc=Shockwave Flash Component File
swd=Shockwave Flash Debug
swt=Shockwave Flash Template
t=Turing Source Code
targets=MSBuild Targets File
tcl=TCL Script
tcs=Tahoe Server Content Source
tdb=ProWorx NXT Title Data with Blocking
tdf=ProWorx NXT Title Data File
tdl=MathType Translator Definition Language
tdm=LabVIEW Binary Measurement with XML Header
tdms=LabVIEW Binary Measurement
tes=Tool Encapsulation Specification
tfp=ProWorx NXT Full Page Data File
tgt=Watcom IDE Target File
tlb=Visual Basic OLE Type Library
tld=Tag Library Descriptor
tlh=Visual C++ TLH Header
tli=Visual C++ TLI Header
tmf=Trace Message Format File
tml=Tapestry Markup Language Document
tmml=Tcl Manual Markup Language File
tmx=Translation Memory Exchange Document
tr=TCL Trace Output
trs=WinDev HyperFileSQL Transaction Log
trx=WinDev HyperFileSQL Transaction TRX Log
tsf=ProWorx NXT Symbol File
tsq=Transact-SQL Script
tsql=Transact-SQL Script
tt=Visual Studio T4 Text Template
tvsconfig=RAD Studio Modeling Configuration
ui=QT User Interface
urf=ProWorx NXT User Configurable Register Editor Data
usl=ProWorx NXT USL Loadable
vbg=Visual Basic Project Group
vbhtml=Razor VB Web Page
vbl=Visual Basic Control Licensing File
vbr=Remote Automation RegistrationFile
vbw=Visual Basic Workspace
vbx=Visual Basic Custom Control
vbz=Visual Basic Wizard Launch File
vch=Vocola Include File
vcl=Vocola Source Code
vcx=Visual FoxPro Class Library
vdm=VDM Source Code
vi=LabVIEW Virtual Instrument
vix=ACUCOBOL-GT Index
vls=Visual Localize Script
vlx=AutoLISP Visual LISP Executable
vm=Velocity Macro File
vmt=Valve Source Material Data
voc=Mizar Vocabulary File
vsdisco=Visual Studio .NET Dynamic Discovery Data
vsh=Microsoft DirectX D3D Vertex Shader
vsmacros=Visual Studio .NET Macros
vso=Microsoft DirectX D3D Compiled Vertex Shader
vspscc=Visual Studio Project Source Control
vsscc=Visual Studio Solution Source Control Temporary File
vssscc=Visual Studio Solution Source Control
vtf=Valve Source Texture Data
vtk=ParaView VTK Data File
vtm=Visual Tool Markup Language Document
vtml=Visual Tool Markup Language Document
vtp=ParaView VTK Poly Data
vtr=ParaView VTK Rectilinear Grid
vtu=ParaView VTK Unstructured Grid
vtx=Valve Source Mesh Strip Data
vvd=Valve Source Model Vertex Data
w=OpenEdge ABL Procedure File
wct=Visual Basic WebClass HTML Template
wde=WinDev Report File
wdg=WinDev Procedures
wdi=WinDev Component Description
wdk=WinDev Component
wdt=WinDev Template File
wdw=WinDev Window File
wdy=WinDev Run-Time Template
webinfo=Visual Studio .NET Web Information Data
wfs=Windows Script File
widget=HybridJava Widget
wixobj=Windows Installer XML Object
wkf=KF Webserver Script
wln=Novell Localisation Workbench Workspace
wlog=WinDev Runtime Log
workspace=Code::Blocks Workspace
wsct=WinDev Test Scenario
wse=Wise Package Studio Script
wsi=Wise Package Studio Installer Package
wsm=Wise Package Studio Merge Module
wte=WinDev Report Template
wwn=WebDev Browser Procedures
wwt=WebDev Page Template
wxi=Windows Installer XML Include
wxres=WinDev Automatic Test Results
wxs=Windows Installer XML Source
wxt=WinDev Automatic Test
x=XBLite Source Code
x=Microsoft DirectX D3D Object
xap=XACT Project File
xbl=XBLite Source Code
xcl=IAR System Linker Command File
xdf=ProWorx NXT Extended Memory Data File
xfl=Adobe Flash Exchange File
xgr=GraphEdit Filter Graph Markup Language
xib=Apple Interface Builder Development-Time Resources
xl=XBLite Source Code
xmla=XML for Analysis File
xsc=Dataset Designer Internal Data
xss=Dataset Designer Surface Data
xst=IBM WebSphere Query Template
xul=XML User Interface Language File
y=Yacc Source
yacc=Yacc Source