!ws=WordStar 2000 Temporary File
1=Unix Manual Page
123=Lotus 123 Spreadsheet
12m=Lotus 1-2-3 Smartmaster Template
1st=Readme Text
2=Unix Manual Page
2d=VersaCAD 2D Drawing
3=Unix Manual Page
3d=Stereo CAD-3D Model
3d2=Stereo CAD-3D Model
3db=3DMark Report Database
3dl=LightConverse 3D Scene
3dm=OpenNURBS 3D Model
3dmf=QuickDraw 3D Metafile
3dp=Serif 3DPlus File
3ds=Autodesk 3D Studio Scene
3dx=Rhino 3D Model
3dxml=3D XML Document
4=Unix Manual Page
5=Unix Manual Page
6=Unix Manual Page
7=Unix Manual Page
8=Unix Manual Page
9=Unix Manual Page
aaf=Advanced Authoring Format File
abc=Business Card Maker Document
abs=Abs Spreadsheet
abt=ED-IT PC AsIs Braille Text File
abw=AbiWord Document
accdb=Microsoft Access 2007 Database
accde=Microsoft Access 2007 Executable
accdr=Microsoft Access 2007 Run-time
accdt=Microsoft Access 2007 Database Template
adb=Ability Database Document
add=Alphacam Diecut Drawing
ade=Microsoft Access Project Extension
adsk=Autodesk Exchange File
aed=Alphacam Wire EDM Drawing
afd=Alphacam Flame Drawing
aib=ArcInfo Binary Coverage
ait=Adobe Illustrator Template
ajd=Alphacam Water Jet Drawing
ald=Alphacam Laser Drawing
all=Lotus 1-2-3 Worksheet Formatting Data
amd=Alphacam 2D/3D Mill Drawing
an8=Anim8or Document
anb=i2 Analyst's Notebook Data
ans=ANSI Art Text
apd=Alphacam Punch Drawing
apr=Lotus Approach 97 Document
ard=Alphacam Router Drawing
arr=Remedy ARS Report
asc=ASCII Armored GPG/PGP File
asc=Plain Text File
ascii=Plain Text File
asd=Alphacam Stone Drawing
asd=Microsoft Word AutoRecovery File
ase=Autodesk 3D Studio ASCII Scene Export
asm=Solid Edge Assemblies Document
ast=ClarisWorks Assistant
asy=Asymptote Document
atd=Alphacam Lathe Drawing
atom=Atom Syndication Format
avery=Avery Design and Print Online Label
awd=Microsoft Fax Document
awd=Ability Draw Document
aws=Ability Spreadsheet Document
awt=AbiWord Template
aww=Ability Write Document
ban=Broderbund PrintMaster Banner
bbl=BibTeX Bibliographic Reference
bbs=BBS Directory List
bcf=Belltech Business Card Designer Pro Document
bdb=Microsoft Works Database Backup
bfc=Windows 95 Briefcase Document
bib=BibTeX Document
biz=Broderbund PrintMaster Business Card
bll=Binary Lasergraphics Language Document
bn=NewsRoom Document
bnk=ExamView Question Bank
bns=BinNews BNS File
book=Adobe FrameMaker Book
brd=Cadence Allegro PCB Layout
bro=PrintShop Deluxe Brochure
bst=BibTeX Document Style
btab=ASCII Guitar Tab
bwp=BuRg3r Web Page
cad=Autodesk QuickCAD Document
cal=Broderbund PrintMaster Calendar
calx=Calendar Printing Assistant Template
car=Broderbund PrintMaster Card
car=NeoBook Cartoon
cas=Comma-Delimited ASCII File
catdrawing=Catia Drawing
catpart=Catia V5 Part Description Document
catproduct=Catia V5 Product Description Document
cbt=Computer-based Training Document
cct=Macromedia Director Compressed Cast
cdb=Pocket Access Document
cdc=Nero Cover Designer Import Document
cdd=ConceptDraw Pro Drawing
cdk=CADKEY Document
cds=ChemDraw Stationery Document
cdw=CeledyDraw Document
cdx=ChemDraw Exchange Document
cdxml=ChemDraw XML Document
cer=Broderbund PrintMaster Certificate
cg=Guitar Chord Groover Chord
cgr=Catia V5 Drawing
ch3=Harvard Graphics 3.0 Chart
chm=Compiled HTML Help
chopro=Chord Pro Chord
chord=Guitar Chord File
chp=Corel Ventura Chapter
cil=Microsoft ClipArt Gallery Download Package
clt=cdrLabel Template
cmp=Solid Edge Wire Harness Design
cmp=Chord Pro Chord
cmx=Corel Presentations Exchange Document
cnd=ControlDraw Diagram
cndx=Avery DesignPro for Mac Document
cnt=Windows Help Content
co=Cult3D Object
cob=Caligari TrueSpace Object
col=HTML Help Collection
con=Solid Edge Wire Harness Design
cov=Fax Cover Page
cph=Corel Print House Document
cpl=Corel Colour Palette
cpr=Corel Presents Presentation
cpy=eCopy Document
crb=BigOven Core Recipe Box
crd=Guitar Chord File
csd=Compact Shared Document
css=Cascading Style Sheets
cst=Macromedia Director Cast
csv=Comma-Separated Values
ctb=Color-dependent Plot Style Table
ctf=WhereIsIt Catalog File
ctg=WhereIsIt Catalog Group File
ctm=WhereIsIt Template File
ctx=Creativyst Table eXchange Document
cwb=Cakewalk Sonar Bundle
cwf=CorelDraw Workspace
cwk=ClarisWorks Document
cws=ClarisWorks Template
cxt=Macromedia Director Protected Cast
dae=Collada Digital Asset Exchange
dap=Microsoft Access Data Access Page
dc=DesignCAD Document
dca=IBM DisplayWrite Document
dec=DEC DX Document
des=Intuit QuickBooks Template
dff=RenderWare 3D Model
dfm=Help and Manual eBook Template
dft=Solid Edge Draft Document
dfx=Softdesk Drafix CAD Document
dgn=Bentley MicroStation Drawing
dia=Dia Diagram
dif=Data Interchange Format
diz=Archive Description
dmz=DMesh 3D Model
doc=Microsoft Word Document
doc=WordStar 2000 Document
doc=Corel WordPerfect Document
docm=Microsoft Word 2007 Document
docmhtml=Microsoft Word 2007 HTML Document
docx=Microsoft Word 2007 Document
dot=Microsoft Word Document Template
dotm=Microsoft Word 2007 Template
dotx=Microsoft Word 2007 Template
dpb=Caere FaxMaster Document
dqy=Microsoft Excel Database Query
dra=Cadence OrCAD Component Footprint
drd=PL Designer Document
drf=Autodesk 3D Scene
drp=DReport Document
drw=Micrografx Designer Drawing
ds4=Micrografx Designer Document
dsd=Autodesk Drawing Set Description
dsf=Micrografx Designer Document
dsv=Delimiter-Separated Values
dtd=Document Type Definition
dtp=Publish-It Document
dtx=Fiberworks Document
dvg=Micrografx Graphics Works Document
dvi=Device Independent File
dwf=Autodesk Design Web Format
dwfx=Autodesk DWF XPS Document
dwg=Autodesk AutoCAD Drawing
dwt=Autodesk AutoCAD Template
dwt=Dreamweaver Web Template File
dx=DEC DX Document
dxb=Autodesk Drawing Interchange Binary
dxe=Autodesk AutoCAD Data Extraction Template
dxf=DEC DX Document
dxf=Autodesk Drawing eXchange File
dzm=DirectorZone Menu Template
dzt=DirectorZone Title Template
easm=eDrawing Assembly Document
easmx=Microsoft XPS Assemply Document
ebc=EBCDIC Document
ecw=EasyCAD for Windows Drawing
edrw=eDrawing Drawing Document
edrwx=Microsoft XPS Drawing Document
eef=Embird Editor File
efx=eFax Document
eio=EIOffice Document Binder
email=Microsoft Outlook Express E-Mail
eml=Microsoft Outlook Express E-Mail
eng=Readme Text
ent=SGML/XML External Entity
env=Broderbund PrintMaster Envelope
enx=EverNote Document
eot=ExamView Online Test Data
eprt=eDrawing Parts Document
eprtx=Microsoft XPS Parts Document
er1=ERwin Diagram
erx=ERwin Model
ess=EasySpreadsheet Document
eta=Keyhole Placemark File
etf=Enigma Transportable File
ets=Enthuware Test Studio Document
evy=Envoy Document
exb=Exercise Builder Plan
excel=Microsoft Excel Worksheet
excelml=Excel Markup Language
eyb=Microsoft Encarta Yearbook Update
fab=Fab@Home Fabber Model
faq=Frequently Asked Questions Text
fax=WinFax Document
fbx=Autodesk FBX Document
fcd=FastCAD for DOS Drawing
fcw=FastCAD for Windows Drawing
fdf=Adobe Acrobat Form Data Format Document
fdr=Final Draft Document
fds=Final Draft Secure Copy
ffo=Adobe Photoshop File Info
ffs=FME Feature Store
flo=iGrafx FlowCharter Document
flw=Kivio Flowchart Document
fly=GNU Lilypond Document
fm=Adobe FrameMaker Document
fm1=Lotus 1-2-3 V2 Spreadsheet
fm2=Lotus 1-2-3 Worksheet Formatting Data
fm3=Lotus 1-2-3 Worksheet Formatting Data
fme=FME Document
fmt=Microsoft Schedule Plus Print
fmt=Lotus 1-2-3 Worksheet Formatting Data
fo=XSL-FO Formatted Form
fp=FileMaker Pro Document
frl=Accelio FormFlow Document
frz=Accelio FormFlow Locked Document
fs=FlexiSign Document
ftg=Windows Help Full Text Group File
ftl=Family Tree Legends Document
fts=Windows Help Full-Text Search Index
ftw=Family Tree Maker Document
fw3=Framework III Document
fxd=WinFax Document
fxi=WinFax Document
fxm=WinFax Document
fxo=WinFax Document
fxp=FontExpert Document
fxr=WinFax Document
fxs=WinFax Document
g=BRL-CAD Geometry Document
gabw=AbiWord Gzip Compressed Document
gbxml=gbXML Document
gcd=General Content Descriptor
gcx=Macintosh Grapher Document
gdc=Iconics GraphWorx32 Display for WinCE
gdf=Iconics GraphWorx32 Display
gdl=ArchiCAD Geometric Description Language File
gds=GDSII Document
gds2=GDSII Document
ged=GEDCOM Document
gen=GenStat Command File
ger=Readme Text
gfd=GNUe Form Data
ggb=GeoGebra Document
ggt=GeoGebra Tool
gid=Windows Global Index File
glk=GenStat ODBC Export Link
gly=Microsoft Word Glossary Data
gml=Geography Markup Language Document
gom=gOpenMol Model
gp3=Guitar Pro Tabulature
gp4=Guitar Pro Tabulature
gp5=Guitar Pro Tabulature
gqsx=Microsoft Office SmartArt Styles
gra=Microsoft Graph Chart
graffle=OmniGraffle Drawing
gsa=Microsoft Office Groove 2007 Archived Worspace
gsd=Profibus Generic Station Description
gsh=GenStat Spreadsheet
gsp=Sketchpad Document
gta=Microsoft Office Groove 2007 Archive
gtp=Guitar Pro Tabulature
gwb=GenStat Book
gxd=General CADD Pro Drawing
hdd=HotDisc Designer Document
hdm=Handheld Device Markup Language
hdml=Handheld Device Markup Language
help=Windows Help File
hf=RayShade HeightField Format
hfd=HotDocs Form Document
hlp=Windows Help File
hmskin=Help and Manual Skin File
hpd=HotDocs PDF Document
hsf=HOOPS Stream File
htc=HTML Component
htext=WebKNotes HTXT Document
htm=Hypertext Markup Language Document
html=Hypertext Markup Language Document
htx=Extended HTML Template
htxt=WebKNotes HTXT Document
hwp=Hangul Word Processor Document
hxl=Microsoft Help 2 Registered Namespace List
hxn=Hexagon 3D Model
hxs=MS Help 2 Compiled Help
hyp=Adobe Acrobat Spelling Dictionary
iam=Autodesk Inventor Assembly Model
icml=Adobe InCopy Markup Language Document
ics=IronCAD Scene
ics=iCalendar File
icw=InterCAD Document
id4=Infini-D Scene
ide=Autodesk Inventor iFeature File
idi=I-DEAS Document
ido=Infini-D 3D Object
ids=Infini-D Scene
idv=Autodesk Inventor Design View
idw=Autodesk Inventor Drawing
ifcxml=Industry Foundation Classes XML
iges=IGES Drawing
igf=Intercept Geometry File
igr=SmartSketch Drawing
igs=IGES Drawing
ihf=Inspiration Handheld Document
iif=Intuit QuickBooks Interchange File
ilg=InstallShield Log
imp=Impatica Classic Document
imr=Impromptu Report File
ind=Adobe InDesign Template
indb=Adobe InDesign Book
indl=Adobe InDesign Library
indt=Adobe InDesign Template
info=GNU Info Document
inm=Caere FaxMaster Fax
intaglio=Intaglio Drawing
ion=Archive Description
ipf=Intercept Part File
ipn=Autodesk Inventor Presentation
ipt=Autodesk Inventor Part
iqy=Microsoft Excel Web Query
isf=Inspiration Concept Map Document
isf=Intercept Symbol File
iv=OpenInventor 3D Data
iwa=IBM Writing Assistant Document
jnb=SigmaPlot Workbook
jnt=Microsoft Windows Journal Document
jpn=Readme Text
jt=JT Open 3D Model
jtd=Ichitaro Document
jtp=Microsoft Windows Journal Template
jtx=Jrju Text
kes=Kurzweil 3000 Document
key=iWork Keynote Presentation
keynote=iWork Keynote Presentation
kid=Kidspiration Document
kit=20-20 Design File
kml=Keyhole Markup Language File
kmz=Compressed KML File
kth=iWork Keynote Theme
laccdb=Microsoft Access 2007 Database Lock
latex=LaTeX Document
lbi=Dreamweaver Library
lbl=Broderbund PrintMaster Label
ldf=Luratech Portable Document
ldr=LDraw Model File
let=Broderbund PrintMaster Letterhead
lot=LaTeX List of Tables
lsg3x=LinSig 3 Document
lwp=Lotus Word Pro Document
lws=Lightwave 3D Scene
lwsc=Lightwave 3D Scene
lxf=LEGO Digital Designer Model
ly=GNU Lilypond Document
lyr=bestIMAGE Layer Data
m15=thinEdge M15 File
ma=Autodesk Maya 3D ASCII Scene
ma=Mathematica ASCII File
maf=Microsoft Access Form
mag=Microsoft Access Diagram Shortcut
mam=Microsoft Access Macro
man=Unix Manual Page
maq=Microsoft Access Query
mar=Microsoft Access Report
mas=Microsoft Access Stored Procedure
mat=Microsoft Access Table
mau=Microsoft Access Function Shortcut
mav=Microsoft Access View Shortcut
maw=Microsoft Access Data Access Page
max=Autodesk 3D Studio Max Scene
mb=Autodesk Maya 3D Binary Scene
mb=Mathematica Binary File
mbb=ManaBook Document
mbf=Microsoft Money Backup
mcd=VectorWorks Drawing Document
mcf=MasterCook CookBook File
mcr=C.a.R. Macro
mcw=Microsoft Word for Macintosh Document
mcx=MICRO CADAM-X/6000 Model Data
md=Mayura Draw Document
md60=MacDraft 6.0 Document
mda=Microsoft Access Add-in
mdb=Microsoft Access Database
mdd=Motion Designer Document
mdd=MacDraft Drawing Document
mde=Microsoft Access Database
mdl=Simulink Model
mdt=Microsoft Access Add-in
mdz=Microsoft Access Wizard Template
me=Readme Text
mem=Corel WordPerfect Macro Editor Macro
mer=Data Interchange Format
met=OmniPage Document
mf1=I-DEAS Model
mf2=I-DEAS Model
mfp=Macromedia Flash Paper
mht=Multipurpose Internet Mail Extension HTML
mhtm=Multipurpose Internet Mail Extension HTML
mhtml=Multipurpose Internet Mail Extension HTML
mic=Microsoft Image Composer File
mif=Adobe FrameMaker Interchange Format
mlb=Lotus Symphony Macro Library
mli=Autodesk 3D Studio Material Library
mlm=Novell GroupWise Saved E-Mail
mma=Master Album Maker Document
mml=Mathematical Markup Language Document
mnl=Help and Manual Print Manual Template
mno=Dreamweaver Design Notes
mny=Microsoft Money Data
moi=Readme Text
mpf=Microsoft Media Package File
mpp=Microsoft Project Document
mppx=Microsoft Project Document
mps=Garmin MapSource Document
mpt=Microsoft Project Template
mrd=MathRevolt Ininity Document
mrml=Medical Reality Modeling Language File
mrp=MathRevolt Ininity Plot
msg=Microsoft Outlook E-Mail
mtd=Musicnotes Digital Sheet Music
mtf=MasterCook Document
mts=Viewpoint MTS Document
mw=MacWrite Text Document
mwf=Autodesk Mapguide Map Document
mwp=Lotus Wordpro Smartmaster File
mwx=Autodesk Mapguide Map XML
nb=Mathematica Notebook File
nbk=SMART Notebook Document
nbml=Mathematica NotebookML File
ncd=Nero Cover Designer Document
ncd=NoteCase Pro Document
nce=NoteCase Pro Encrypted Document
nct=Nero Cover Designer Template
ncz=NoteCase Pro Compressed Document
nd=Intuit QuickBooks Network Data File
neu=Pro/ENGINEER Neutral Assembly
nfo=NFO File
nfo=Microsoft System Information
nft=NetObjects Fusion Template
nhf=Nero HFS CD Compilation
nhv=Nero HD-Burn Video Compilation
nmd=Nero MiniDVD Compilation
not=E-Sword Notice
not=Veign Note-It Note
note=Plain Text File
notebook=SMART Notebook Document
notes=Plain Text File
nr3=Nero MP3 CD Compilation
nr4=Nero AAC CD Compilation
nra=Nero Audio CD Compilation
nrb=Nero Boot CD-Rom Compilation
nrc=Nero UDF/ISO CD-Rom Compilation
nrd=Nero DVD-Video Compilation
nre=Nero CD Extra Compilation
nrh=Nero Hybrid CD-Rom Compilation
nri=Nero ISO9660 CD-Rom Compilation
nrm=Nero Mixed Mode CD Compilation
nrs=Nero CD-Rom (EFI Boot) Compilation
nru=Nero UDF CD-Rom Compilation
nrv=Nero VideoCD Compilation
nrw=Nero WMA CD-Rom Compilation
nsd=Nero Super VideoCD Compilation
nsr=NewsRoom Document
ntt=MediaFACE Template
numbers=Numbers Spreadsheet File
nvc=Nero Vision Compilation
nwd=NavisWorks JetStream Publisher Model
nwf=NavisWorks File
nws=Microsoft Internet News Message
nzb=Newzbin NZB File
o2c=O2C 3D Model
oa2=Fujitsu Oasys 2 Document
oas=Fujitsu Oasys Document
obd=Microsoft Office Binder Document
obml=Opera Binary Markup Language Document
obp=Bryce 3D Model
obt=Microsoft Office Binder Template
obz=Microsoft Office Binder Wizard
odb=OpenOffice.org Base Database
odc=OpenDocument Chart
odf=OpenDocument Formula
odm=OpenDocument Master Document
odp=OpenDocument Presentation
ods=OpenDocument Spreadsheet
odt=OpenDocument Text
ofc=Open Financial Connectivity Document
ofs=Microsoft Outlook Form Storage
oft=Microsoft Outlook Template
ofx=Open Financial Exchange Document
olf=OyezForms Legal Document
oml=TracePro Model
one=Microsoft OneNote Document
oo3=OmniOutliner 3 Document
oog=Object Oriented Graphics Library
oogl=Object Oriented Graphics Library
opd=OmniPage Pro Document
opml=Outline Processor Markup Language File
opx=Microsoft Organization Chart Document
oqy=Microsoft Excel OLAP Query
or5=Lotus Organizer 5 Document
or6=Lotus Organizer 6 Document
ort=IBM Rich Text Editor Document
otf=OpenDocument Formula Template
oth=OpenDocument HTML Template
otp=OpenDocument Presentation Template
ott=OpenDocument Text Template
ov=OrgPlus Chart
ovr=The Overlay Maker Overlay
p65=Adobe Pagemaker 6.5 Document
pages=Apple Pages Document
pal=Corel Colour Palette
par=Solid Edge Part Document
pc=Personal Composer Document
pcl=Printer Command Language Document
pcr=Broderbund PrintMaster Post Card
pda=PrintShop Deluxe Document
pdf=Portable Document Format
pdl=PrintShop Deluxe Flyer Document
pdo=Pepakura Designer Pattern
pdp=Adobe Photoshop PDF File
pdt=InkWriter/Note Taker Template
pdx=Adobe Acrobat Catalog Index
pff=Formatta Portable Form File
pg=C64 Printfox/Pagefox Document
ph=NewsRoom Document
pln=ArchiCAD 3D Model
plt=Autodesk AutoCAD Plot Drawing
pm5=Adobe Pagemaker 5.0 Document
pm6=Adobe Pagemaker 6.0 Document
pmd=Adobe Pagemaker 7.0 Document
pmg=Adobe Pagemaker Group
pmk=ArchiCAD PlotMaker Document
pmt=Adobe Pagemaker 7.0 Template
pmv=PlanMaker Spreadsheet Template
png=Corel Paint Shop Pro Browser Catalogue
pot=Microsoft PowerPoint Template
potm=Microsoft PowerPoint 2007 Template
potx=Microsoft PowerPoint 2007 Template
ppam=Microsoft PowerPoint 2007 Add-in
ppax=Microsoft PowerPoint 2007 Add-in
ppp=Serif PagePlus Publication
pps=Microsoft PowerPoint Slideshow
ppsm=Microsoft PowerPoint 2007 Slideshow
ppsx=Microsoft PowerPoint 2007 Slideshow
ppt=Microsoft PowerPoint Presentation
pptm=Microsoft PowerPoint 2007 Presentation
pptmhtml=Multipurpose Internet Mail Extension HTML
pptx=Microsoft PowerPoint 2007 Presentation
ppx=Serif PagePlus Template
prn=Printer Text File
pro=Chord Pro Chord
prt=Solid Edge Parts Document
prt=CADKEY Part Document
prt=Corel Presentations Template
prtl=Adobe Premiere Title Template
ps5=ProSteel 5 Document
psm=Solid Edge Sheet Metal Document
psq=Adobe Premiere 6 Storyboard
pss=Pocket SlideShow Presentation
pss=Pod SnapShot
psw=Pocket Word Document
pt=Plone Page Template
ptb=Power Tab Editor Tabulature
ptb=Pro/ENGINEER Pattern Table
pub=Corel Ventura Publisher Publication
pub=Microsoft Publisher Document
pubmhtml=Microsoft Publisher Archived HTML
pvm=HP Photo Album
pwd=Pocket Word Document
pwi=Pocket Word Document
pwt=AutoCAD Publish To Web Template
pxl=Pocket Excel Document
qba=Intuit QuickBooks Accountant's File
qbb=Intuit QuickBooks Backup File
qbm=Intuit QuickBooks Portable Company File
qbr=Intuit QuickBooks Report Template
qbw=Intuit QuickBooks Company File
qbx=Intuit QuickBooks Accountant's Export
qby=Intuit QuickBooks Accountant's Import
qdt=QuarkXPress Dictionary Data
qht=QuickTime HTML
qhtm=QuickTime HTML
qhtml=QuickTime HTML
qpt=QuarkXPress Project Template
qpw=Quattro Pro for Windows Spreadsheet
qtl=QuickTime Media Link
qvw=QlikView Document
qwd=QuarkXPress Web Document
qxb=QuarkXPress Book
qxd=QuarkXPress Document
qxl=QuarkXPress Library
qxt=QuarkXPress Document Template
rad=Radiance Scene
rcs=RandomControl Arion Scene
rdf=Resource Description Framework
rdl=Report Definition Language File
rdo=Xerox Raster Document Object
rds=Ray Dream Studio Scene
readme=Readme Document
rels=Microsoft Office 2007 Relationships
rep=SAP Business Objects Report
ret=SAP Business Objects Report Template
rft=Revisable-Form Text
rgo=RepliGo Document
ris=Research Information Systems Citation
rls=Readme Text
rml=Redline Markup Language Document
rmr=ResumeMaker Resume
rod=Actuate e.Report Report Object Design
roff=Unformatted Manual Page
rox=Actuate e.Report Report Object Executable
rpmsg=Microsoft Restricted Permission Message
rqy=Microsoft Excel OLE DB Query
rsl=Corel Paradox Report
rss=RSS Feed File
rst=reStructuredText File
rtf=Rich Text Format Document
rtfd=TextEdit Document
rtg=Autodesk Maya 3D Scene Data
rtx=Rich Text Format Document
rvt=Autodesk Revit Document
sam=Ami Pro Document
sbk=Scrapbook Factory Deluxe Scrapbook
sc2=Microsoft Schedule Plus Interchange
scd=Microsoft Schedule Plus Document
sch=Microsoft Schedule Plus File
scn=Caligari TrueSpace Scene
scsv=Sealed CSV Document
sda=StarOffice Draw Template
sdb=OpenOffice Base Database
sdc=OpenOffice Calc Spreadsheet
sdd=StarOffice Presentation
sdf=Iconics GraphWorx32 Symbol Library
sdl=Scene Description Language Document
sdl=Web Services Description Language Document
sdm=StarOffice Mail Document
sdoc=Sealed Word Document
sdocm=Sealed Word 2007 Document without Macros
sdocx=Sealed Word 2007 Document
sdot=Sealed Word Template
sdotm=Sealed Word 2007 Template without Macros
sdotx=Sealed Word 2007 Template
sdp=StarOffice Packed Presentation
sdr=SmartDraw Drawing
sdt=SmartDraw Template
sdw=StarOffice Writer Document
seml=Sealed EML Document
sequ=Adobe Acrobat Batch Sequence
sgl=StarWriter 5.x Global Document
sgm=Standard Generalized Markup Language Document
sgml=Standard Generalized Markup Language Document
sh3=Harvard Graphics 3.0 Show Presentation
sht=HTML Document with SSI
shtm=HTML Document with SSI
shtml=HTML Document with SSI
shw=Corel Presentations Document
sib=Sibelius Music Notation
sig=Broderbund PrintMaster Poster
sig=GPG/PGP Signature
skd=Autodesk AutoSketch Drawing
skin=Help and Manual Viewer Template
skv=Semicolon Separated Values
sla=Scribus Document
slb=Autodesk AutoCAD Slide Library
sld=Autodesk AutoCAD Slide Library
slddrt=SolidWorks Sheet Document
slddrw=SolidWorks Drawing Document
sldm=Microsoft PowerPoint 2007 Slide
sldx=Microsoft PowerPoint 2007 Slide
sly=GNU Lilypond Document
smf=OpenOffice Math Formula
smm=Ami Pro Macro
snp=Microsoft Access Report SnapShot
soap=Simple Object Access Protocol Message
spdf=Sealed PDF Document
spl=FutureSplash Animator Document
spot=Sealed PowerPoint Template
spotm=Sealed PowerPoint 2007 Template without Macros
spotx=Sealed PowerPoint 2007 Template
sppt=Sealed PowerPoint Presentation
spptm=Sealed PowerPoint 2007 Presentation without Macros
spptx=Sealed PowerPoint 2007 Presentation
srtf=Sealed Rich Text Format Document
ssi=HTML Document with SSI
stb=Named Plot Style Table
stc=OpenOffice Calc Template
std=StarOffice DrawingTemplate
step=ISO 10303 STEP Document
step=Catia Document
sti=StarOffice Impress Template
stl=StereoLithography Data
stml=Sealed HTML Document
stp=Catia Document
stw=StarOffice Writer Template
stxt=Sealed Text Document
sty=LaTeX Style Definition
sty=Corel Ventura Publisher Style Sheet
svf=Simple Vector Format Document
swg=SWAG Pascal Snippets
sxc=OpenOffice Calc Document
sxd=OpenOffice Draw Document
sxg=OpenOffice.org Writer Global Document
sxi=OpenOffice Impress Document
sxls=Sealed Excel Document
sxlsm=Sealed Excel 2007 Document without Macros
sxlsx=Sealed Excel 2007 Document
sxlt=Sealed Excel Template
sxltm=Sealed Excel 2007 Template without Macros
sxltx=Sealed Excel 2007 Template
sxm=StarOffice Math Document
sxml=Sealed XML Document
sxw=OpenOffice Writer Document
t65=Adobe Pagemaker 6.5 Template
tab=ASCII Guitar Tab
tbl=Adobe Pagemaker Table
tct=TurboCAD Template
tcw=TurboCAD Drawing
tcx=TurboCAD Drawing (ASCII)
tee=TeeChart Chart Template
tem=Microsoft Frontpage Website Template
template=Apple Pages Template
tex=LaTeX Document
texi=GNU Texinfo Document
texinfo=GNU Texinfo Document
text=Plain Text File
thmx=Microsoft Office 2007 Theme
tlg=Intuit QuickBooks Transaction Log
tm5=Adobe Pagemaker 5.0 Template
tm6=Adobe Pagemaker 6.0 Template
tmd=TextMaker Document
tmv=TextMaker Document Template
toc=Adobe FrameMaker TOC
top=Topocad Drawing Document
topviw=TopSolid Viewer Document
tst=Corel WordPerfect 5 Printer Test Document
tst=ExamView Test File
tsv=Tab-Separated Values
ttl=Turtle Language Document
tts=ToolBook Translation System Document
txd=RenderWare Texture Data
txt=Plain Text File
u3d=Universal 3D File
uof=Uniform Office Format Document
uop=Uniform Office Format Presentation
uos=Uniform Office Format Spreadsheet
uot=Uniform Office Format Text
utf=UTF-8 Encoded Text File
utf8=Unicode UTF8 Encoded Text Document
uxdc=Microsoft Office XML Data Source
vc6=Ashlar-Vellum Graphite Document
vcard=VCard File
vce=Visual CertExam Exam Data
vcf=VCard File
vcs=vCalendar Document
vda=VDA-FS CAD Document
vdx=Microsoft Visio Diagram XML
vew=Lotus Approach View
vfc=VentaFax Cover Page Template
vinf=ReMpeg Log
vl=Visual Labels Document
vlb=Corel Ventura Library
vmg=vMessage Text
vml=Vector Markup Language Document
vnt=vNote Text
vor=StarOffice Draw Template
vp=Corel Ventura Publisher Publication
vrd=Microsoft Visio Report Definition
vrl=VRML Document
vrml=VRML Document
vsd=Microsoft Visio Diagram
vss=Microsoft Visio Stencil
vst=Microsoft Visio Template
vsw=Microsoft Visio Workspace
vsx=Microsoft Visio Stencil XML
vtm=VirtualTourist Markup Language Document
vtml=VirtualTourist Markup Language Document
vtx=Microsoft Visio Template XML
vwx=VectorWorks 2008 Document
w50=Corel WordPerfect Document
w51=Corel WordPerfect Document
w60=Corel WordPerfect Document
w61=Corel WordPerfect Document
wb1=Quattro Pro for Windows Spreadsheet
wb2=Quattro Pro for Windows Spreadsheet
wb3=Quattro Pro for Windows Spreadsheet
wbk=Microsoft Word Backup
wcm=Corel WordPerfect Macro
wdb=Microsoft Works Database
wdf=Workshare DeltaView Deltafile
wdl=DynaDoc Document
web=Xara Web Document
wfx=WinFax Document
wire=Alias Wire File
wiz=Microsoft Word Wizard
wk1=Lotus 123 Spreadsheet
wk1=Lotus 1-2-3 Worksheet
wk2=Lotus 123 Spreadsheet
wk3=Lotus 1-2-3 Worksheet
wk3=Lotus 123 Spreadsheet
wk4=Lotus 1-2-3 Worksheet
wks=Microsoft Works Spreadsheet
wks=Lotus 1-2-3 Worksheet
wks=Lotus 123 Spreadsheet
wku=Lotus 1-2-3 Worksheet
wlc=WISCO Word Power Document
wls=602Tab Workbook
wmc=WordStar 2000 Macro
wml=Wireless Markup Language Document
wp=Corel WordPerfect Document
wp4=Corel WordPerfect Document
wp5=Corel WordPerfect Document
wp6=Corel WordPerfect Document
wpa=Act! Word Processor Document
wpc=WordPad Converter File
wpd=Corel WordPerfect Document
wpf=Corel WordPerfect Form
wpm=Corel WordPerfect Macro
wpostx=Windows Live Writer Post
wps=Microsoft Works Document
wpt=Corel WordPerfect Template
wpw=WordPerfect Works Document
wq!=Quattro Pro Compressed Spreadsheet
wq1=Quattro Pro Spreadsheet
wq2=Quattro Pro Spreadsheet
wr1=Lotus Symphony Spreadsheet
wrd=Psion Word File
wri=Write Document
wrk=Lotus Symphony Spreadsheet
wrl=VRML Document
wrl=Virtual Reality World
wrz=Gzip Compressed WRL File
ws1=WordStar 2000 Document
ws2=WordStar 2000 Document
ws3=WordStar 2000 Document
ws4=WordStar 2000 Document
ws5=WordStar 2000 Document
ws6=WordStar 2000 Document
ws7=WordStar 2000 Document
wsd=WordStar 2000 Document
wsdl=Web Services Description Language Document
wst=WordStar 2000 Template
wt4=Lotus 1-2-3 Smartmaster Template
wvl=WorkView3D Links
x3d=X3D Scene
x3db=X3D Binary Scene
x3dbz=Compressed X3D Binary Scene
x3dv=X3D Classic VRML
x3dvz=Compressed X3D Classic VRML
x3dz=Compressed X3D Scene
xbel=XBEL Bookmark
xbk=SMART Notebook Document
xbrl=eXtensible Business Reporting Language
xbt=SMART Notebook Template
xcm=Concept Map
xdp=XML Data Package
xdr=XML-Data Reduced Schema
xdw=Xerox DocuWorks Document
xfa=XML Forms Architecture Document
xfd=XFDL Document
xfdf=Adobe Acrobat XFDF Document
xfdl=XFDL Document
xfo=XSL-FO Formatted Form
xgl=XGL 3D CAD Model
xht=XHTML Document
xhtm=XHTML Document
xhtml=XHTML Document
xig=XML Instance Generator Document
xl=Microsoft Excel Worksheet
xla=Microsoft Excel VBA Add-in
xlam=Microsoft Excel 2007 VBA Add-in
xlb=Microsoft Excel Toolbar
xlc=Microsoft Excel Chart File
xld=Microsoft Excel Dialogue
xlf=XLIFF Document
xlk=Microsoft Excel Backup
xll=Microsoft Excel Add-in
xlm=Microsoft Excel Macro
xlr=Microsoft Works Spreadsheet
xls=Microsoft Excel Worksheet
xlsb=Microsoft Excel 2007 Document
xlsm=Microsoft Excel 2007 Document
xlsmhtml=Microsoft Excel HTML Spreadsheet
xlsx=Microsoft Excel 2007 Document
xlt=Microsoft Excel Template
xltm=Microsoft Excel 2007 Template
xltx=Microsoft Excel 2007 Template
xlv=Microsoft Excel VBA Module
xlw=Microsoft Excel Workbook
xmcd=Mathcad Worksheet Document
xmcdz=Mathcad Compressed Worksheet
xml=Extensible Markup Language File
xmt=Romulus 3D Modeler Data
xpf=Homestead Sitebuilder Document
xps=XML Paper Document
xs3=XESS Worksheet
xs4=XESS Worksheet
xs5=XESS Worksheet
xsd=Microsoft InfoPath XML Schema
xsf=Microsoft InfoPath Form Definition
xsl=Extensible Stylesheet Language Transformations
xslt=Extensible Stylesheet Language Transformations
xsn=Microsoft InfoPath Form Template
xsx=Microsoft XML Schema Designer View
xtg=QuarkXPress Tags File
xv0=Extensible Virtual World Description Language Document
xv1=Extensible Virtual World Description Language Document
xv2=Extensible Virtual World Description Language Document
xv3=Extensible Virtual World Description Language Document
xvl=Extensible Virtual World Description Language Document
xy=XyWrite Document
xy3=XyWrite III Document
xy4=XyWrite IV Document
xyp=XyWrite III Plus Document
xyw=XyWrite IV Document
ybk=Microsoft Encarta Yearbook
yka=Yenka Model
zabw=AbiWord Gzip Compressed Document
zdl=Avery DesignPro Label
zdx=Avery DesignPro Clipart Index
zed=ZX-Edit Document Block
zgl=Compressed XGL Document
zgt=Oren-made Scientific Document
zir=C.a.R. Figure
zno=Zinio Reader Magazine
ztx=C.a.R. Exported Image