aeh=Archos Reader Ebook
apnx=Amazon Kindle eBook Index
azw=Amazon Kindle eBook
cb7=7-ZIP Compressed Comic Book
cba=ACE Compressed Comic Book
cbr=RAR Compressed Comic Book
cbt=TAR Compressed Comic Book
cbz=ZIP Compressed Comic Book
ceb=Apabi eBook
cebx=Apabi eBook
dnl=DNAML E-book
ea=Amazon Kindle End Announcement
ebk=eBook Pro eBook
ebx=Adobe Reader Electronic Book Exchange File
epub=Open eBook Document
fb2=FictionBook 2 E-Book
ibooks=Apple iBooks Document
kf8=Amazon Kindle Format 8 Ebook
lit=Microsoft Reader E-Book Document
lrf=Sony BBeB E-Book
lrs=Sony BBeB E-Book Source
lrx=Sony BBeB E-Book
mobi=Mobipocket Reader E-Book
nat=Natata eBook Compiler Document
opf=Open Electronic Package Ebook
pdb=Plucker Ebook
pdg=SSReader Digital Book
pkg=Apple Newton eBook
prc=Mobipocket Reader E-Book
rb=Rocket eBook
snb=Shanda Bambook eBook
sva=Manga Browser Comic
tcr=TCR E-book
tebr=Tiny eBook Reader Ebook
tk3=TK3 E-Book
tpz=Amazon Topaz E-book
tr=TomeRaider 2 E-book
tr3=TomeRaider 3 E-book
wol=WOLF eBook
xeb=Apabi eBook