abf=Adobe Binary Format Font
afm=Adobe Font Metrics
auf=Alphacam User Font
bdf=Glyph Bitmap Distribution Format
cfn=Calamus Font Data
cft=ChiWriter Low-res Screen Font
chr=Borland Language Stroke Font
compositefont=Windows Composite Font
dfont=Mac OS X Data Fork Font
eft=ChiWriter Hi-res Screen Font
etx=TeX Font
fdb=Font Definition Block
fnt=Microsoft Windows Font
fnt=General CADD Font
fon=Windows Bitmap Font
gdr=Symbian OS Font
gf=Metafont Generic Font
glf=GLF 3D Font File Format
gxf=General CADD Pro Font
lft=ChiWriter Laser Printer Font
mf=Metafont Font
pfa=Postscript Type1 Font ASCII
pfb=Postscript Type1 Font Binary
pfm=Postscript Type1 Printer Font Metrics
pfr=Portable Font Resource
pft=ChiWriter 9P Matrix Printer Font
phf=QNX Photon Font
sfd=Spline Font Database
tfm=TeX Font Metric
ttc=TrueType Font Collection
ttf=TrueType Font
vf=TeX Virtual Font File
vfb=Fontlab Studio Font
vpl=TeX Virtual Property Lists
woff=Web Open Font Format
xft=ChiWriter 24P Matrix Printer Font