256=Descent Palette Data
2da=Bioware 2-Dimensional Array
aei=Abyss Engine Image
aem=Abyss Engine Mesh
amx=AMX Mod Plugin
apc=Cryo APC Audio
ar=Midtown Madness 2 Game Data
are=Infinity Engine Area Contents
asg=Airport Tycoon Saved Game
bag=Emperor: Battle for Dune Data
bar=Age of Mythology Game Data
bf=Cryo BF Game Data
bif=Bioware Game Data
big=EA Compressed Game Archive
blk=Descent Mission Builder Block
bls=Blockland Saved Game
bms=Be-Music Script
bot=Quake FrogBot Data
bsp=Quake Map Data
bts=Combat Mission Shock Force Saved Scenario
btt=Combat Mission Shock Force Scenario
cbd=Test Drive Unlimited Cache Data
ccx=Spring HAPI Compressed Data File
chrparams=CryENGINE Character Parameters
ck1=Commander Keen Data File
ck2=Commander Keen Data File
ck3=Commander Keen Data File
ck4=Commander Keen Data File
ck5=Commander Keen Data File
ck6=Commander Keen Data File
cli=GTA 4 Movie Clip
cm=GTA San Andreas CLEO Custom Mission
con=Train Simulator Model Identification
crf=Thief Game Data
cry=CryENGINE Map Data
csc=18 Wheels of Steel CSC Data
cwd=Cardwar Cards deck
ddt=Football Manager Data
desc=Battlefield 2 Map Description File
dlg=Bioware Aurora Dialog Data
dni=realMyst 3D Data File
dog=Dogz Dog Data
dpc=Twisted Metal 2 Texture
dsg=Doom Saved Game
dwi=Dance With Intensity Song
dx=Deus Ex Map File
dxs=Deus Ex Saved Game
elb=WWII Fighters Audio Data
erf=Bioware Encapsulated Resource File
erm=In the Wake of Gods ERM Script
erp=Alter Ego Game Archive
fac=Bioware Aurora Faction
feu=Far Cry 3 Data
ff=CoD2 Fast File
frw=RollerCoaster Tycoon 3 Fireworks Data
fst=Crazy Machines 2 Data
fuk=Postal 2 Map Data
gaf=Total Annihilation Texture
gau=MS Flight Simulator Gauge File
gca4=GURPS Character Data
gcs=GURPS Character Sheet Data
gct=Ocarina Code Manager Data
gdf=GURPS Data File
gff=Bioware Generic File Format
gfx=Warcraft 2 Image
git=Bioware Waypoint Instance Struct
glb=Ultimate Stunts Binary 3D Model
glt=Ultimate Stunts Text 3D Model
gm1=Heroes of Might and Magic III Saved Game
gob=Dark Forces Game Archive
gpf=Ragnarok Online Game Patch
grf=Ragnarok Online Game Data
gui=Doom 3 GUI Data
gzr=GunZ Replay
hes=Hudson Entertainment Sound
hog=Descent Mission File
hpi=Spring HAPI Compressed Data File
hps=HPL2 Script
ibt=Texture and Model Data
ifo=Bioware Information File
ik=CryENGINE IK Animation
inv=INVedit File
itp=Bioware Palette Data
iwd=CoD2 Game Data
ja=Trainz Jet Archive
jrl=Bioware Aurora Journal Data
key=Bioware Game Data Key
l=Game of Life Data
lfd=LucasFilm Data
lff=LucasFilm Format Image
lgt=Age of Mythology Lighting Data
lif=Game of Life Data
lom=Lock On 3D Model
lua=World of Warcraft Interface Configuration
m8=Heretic II MipMap Image
ma0=Diablo 2 Game Data
ma1=Diablo 2 Game Data
ma2=Diablo 2 Game Data
ma3=Diablo 2 Game Data
ma4=Diablo 2 Game Data
ma5=Diablo 2 Game Data
mb1=Monster Bash Data
mgn=Star Wars Galaxies 3D Model
mis=Marble Blast Gold Mission
mmx=Command and Conquer Map
mni=Star Trek Elite Force 2 Data
mpm=Max Payne Modfication
mpq=MoPaQ Archive
mrs=GunZ Data
msh=Star Wars Battlefront 3D Model
muz=Hover! MUZ Audio
nav=Quake 3 Bot Navigation Data
nif=NetImmerse Data File
odr=Open IV Model Data
otd=Open IV Texture Data
ovl=Rollercoaster Tycoon 3 Data
pak=Quake Engine Data
pbo=Operation Flashpoint Data
pck=Perfect World Package
peg=Peggle Replay File
pff=Armored Fist 3 Game Archive
pig=Descent Data
plv=Prince of Persia Single Level Data
pof=Descent Model Data
pog=Descent 2 Data
pop=Team Fortress 2 Population Data
psx=Sony Playstation Savegame
pxp=Counter-Strike PODBot Experience Data
pzl=Jigs@w Puzzle
rec=Elasto Mania Replay
rep=GTA San Andreas Game Replay
rfa=Battlefield 1942 Data
rkv=Project Snowblind Game Data
roq=ID Software Game Video
rpl=Toribash Replay
sbg=Company of Heroes Map
scm=StarCraft Map
scx=StarCraft Broad War Map
sd7=Spring 7ZIP Compressed Data File
sdz=Spring ZLIB Compressed Data File
setup=CryENGINE Character Setup
sgh=Guitar Hero 3 Setlist Settings
sii=18 Wheels of Steel Haulin Truck Data
sin=Rise of Nations Data
sin=SiN Data
sm=Stepmania Song
sns=Burnout Paradise Sound
so3=ScummWM MP3 Sound
sog=ScummWM OGG Sound
sou=ScummWM Sound Data
sqf=Operation FlashPoint Function Script
sqs=Operation FlashPoint Script
ssf=Bioware Aurora Sound Set File
sve=Simutrans Saved Game
sxt=Singles Extension
syb=Syberia BINK Video
syj=Syberia Texture
syn=Excessive Speed Data
td4=RollerCoaster Tycoon Track
ter=Black and White 2 Terrain Data
tf=Follin Player II Music
tfc=Unreal Engine 3 Texture File Cache
tgh=Guitar Hero 3 Tier Settings
tlk=Bioware Talk Table
toc=World of Warcraft Add-on TOC
tp4=RollerCoaster Tycoon Track Picture
tre=Star Wars Galaxies TRE Archive
trf=Train Simulator Traffic Pattern
txd=GTA Texture Data
uax=Unreal Tournament Sound Package
uc=UnrealScript File
ufo=Spring HAPI Compressed Data File
ukx=Unreal Tournament Animation Package
umx=Unreal Tournament Music Package
usx=Unreal Tournament Static Meshes
ut2=Unreal Tournament 2003 Map File
utc=Bioware Aurora Creature Data
utd=Bioware Aurora Door Object
ute=Bioware Aurora Encounter Data
uti=Bioware Aurora Item Data
utm=Bioware Aurora Store Data
utp=Bioware Aurora Placeable Object
uts=Bioware Aurora Sound Object
utt=Bioware Trigger Data
utw=Bioware Waypoint Blueprints
utx=Unreal Tournament Texture Package
uxx=Unreal Tournament Cache
uz2=Unreal Tournament 2004 Package
vl2=Tribes 2 Game Data
vmf=Valve Map File
vol=Video Game Data
vpt=Visual Pinball Table
vxl=Tiberian Sun Voxel Animation
w3g=Warcraft 3 Replay
w3m=Warcraft 3 Map
w3x=Warcraft 3 Extension Data
wad=Doom Data File
wai=Warcraft 3 AI Data
wal=Quake 2 Texture
wdr=GTA 4 Model Data
wix=Xara Internal Graphics Data
wtd=GTA 4 Texture Data
wtf=World of Warcraft Config
wtp=Dawn of War Texture
wx=MS Flight Simulator Weather File
wzl=Winzle Puzzle
xp0=Stalker Data
xp1=Stalker Data
xp2=Stalker Data
xs=Age of Empires III AI Settings
xwi=Star Wars: X-Wing Mission Data
z2f=Zoo Tycoon 2 Data
zipfs=18 Wheels of Steel Data
zsd=Dave Mirra Freestyle BMX Data File
zsg=Zillions of Games Solution Saved Game
ztd=Zoo Tycoon Data