adp=SIA dataMap GIS Export
agr=ArcView Ascii Grid
aih=ArcGIS Optional Index
ain=ArcGIS Optional Index
alg=ER Mapper Algorithm Data
apr=ArcView Project
atx=ArcGIS Attribute Index
aux=ArcGIS Auxilliary File
avl=ArcView Legend Template
avx=ArcView Extension
bds=Cadcorp SIS Base Dataset
bilw=ArcGIS BIL World File
blw=ArcGIS BIL World File
bpw=BMP World File
cpg=ArcGIS Codepage
dpn=Depiction Data
ecw=Enhanced Compression Wavelet
ers=ER Mapper Image Header
eww=ER Mapper World Data
fbn=ArcGIS RO Spatial Index
fbx=ArcGIS RO Spatial Index
fly=TerraExplorer Project
fx3=Fugawi Raster Map
fx4=Fugawi Raster Map
gen=ArcView Ungenerate File
gis=Carlson SurvCADD GIS File
gmw=Global Mapper Workspace
gpf=Geosoft Project File
gsb=Golden Software Map Boundary
gsi=Golden Software Interchange
gws=Geosoft Workspace
hdr=ArcGIS ASCII Header
hfa=ERDAS Imagine Hierarchical File Architecture
isx=Intrasis Object File
jfw=JPEG World File
jgw=ArcGIS JPEG World File
jpgw=ArcGIS JPEG World File
kvi=K2Vi Data
lan=ERDAS LAN
lyr=ArcView Layer Data
mif=MapInfo Interchange Format Data
nit=ArcGIS INFO Table Definitions File
pfw=PNG World File
pmf=ArcGIS Published Map
rdc=Idrisi Raster Format Description
ref=Idrisi Raster Format Geographical Reference
rst=Idrisi Raster Format RAW Image
rte=OziExplorer Route Data
rus=GisRussa Map
sbn=ArcGIS Spatial Index
sbx=ArcGIS Spatial Index
sds=Cadcorp SIS Shared Dataset
sed=Cadcorp SIS Export Dataset
shp=ArcView Shape File
shx=ArcView Shape Index
sidx=SharpMap Spatial Index
smp=Idrisi Raster Format Color Table
stn=ArcView Geocoding Standardization
tab=MapInfo Table Document
tfw=TIFF World File
tfw=ArcGIS TIFF World File
tifw=ArcGIS TIFF World File
tpo=Topo Explorer Map
tsd=TNTmips TileSet Definition Data
ttkgp=TatukGIS Project
ulf=Universal List File
vct=Idrisi Vector Image
vdc=Idrisi Vector Documentation
vec=Idrisi Vector
vrt=GDAL Virtual Format
wld=ArcGIS World Data
wor=MapInfo Professional Workspace
xol=Swiss Map Overlay