abm=ArcSoft PhotoBase Album
ale=Avid Log Exchange File
avs=AviSynth Script
b4s=WinAMP 3 Playlist
bootstrap=Flash MP4 Video Bootstrap
bsl=BSPlayer Playlist
camrec=Camtasia Studio Recorded Video
cdz=ROM With a View Data
cmx=Qualcomm Compact Media Extensions
csa=CrystalPlayer Skin
csz=TCMP Skin
dda=DDA Media Package
dnc=Windows Dancer Data
emp=eMusic Playlist
emx=eMusic Download File
enc=Encore Notation Data
f4m=Flash Media Manifest File
f4x=Flash MP4 Video Index
gl=Graphical System for Presentation File
grasp=Graphical System for Presentation File
iff=EA Interchange File Format
ilm=Opus Creator Multimedia File
ism=IIS Smooth Streaming Server Manifest Data
ismc=IIS Smooth Streaming Client Manifest Data
lid=Kodak EasyShare Album Information
mbt=Everio MediaBrowser Edit Data
mfd=Music Finder Database
mmm=Macromind Multimedia Movie
mms=MMS Message Data
mnv=PlayStation Store Paid Content
mrl=Multimedia Retrieval Markup Language File
mrml=Multimedia Retrieval Markup Language File
mvb=Multimedia Viewer Book
nif=Notation Interchange File Format
niff=Notation Interchange File Format
npl=TCMP Playlist
npl=Nokia Playlist
pbw=Photobucket Slideshow
pla=Sansa Playlist File
pla=iRiver Playlist File
plf=BlazeDVD Playlist File
plp=Sandisk Sansa Playlist
ram=RAM Metafile
rmm=RAM Metafile
rmp=Real Metadata Package
rt=RealText Streaming Text File
s2k=Sasami2k Script
sdp=Session Description Protocol File
smi=Synchronized Multimedia Integration Language
smil=Synchronized Multimedia Integration Language
smil=SMIL Document
sml=SMIL Document
ssm=Streaming Media Metafile
tts=Telerik Trainer Session
ucf=Universal Communications Format File
vai=PhotoDub Document.
vpl=Karaoke Player Playlist
vtt=WebVTT Document
wm=Windows Media File
wmd=Windows Media Download Package
wmdb=Windows Media Player Media Catalog
wms=Windows Media Player Skin
wmz=Windows Media Player Compressed Skin
wpl=Windows Media Player Playlist
zpl=Zoom Player Playlist