!bt=BitTorrent Incomplete Download File
!ut=uTorrent File
$$$=General Temporary File
0=Linux Shared Library Link File
2fs=Puppy Linux Save State File
2gr=VGA Graphics Configuration
3gr=VGA Graphics Configuration
73u=TI-73 Explorer OS Upgrade File
8ba=Adobe Photoshop Plugin
8bf=Adobe Photoshop Filter Plugin
8bx=Adobe Photoshop Extension Plugin
8li=Adobe Photoshop Scripting Plugin
8xp=TI-83/84 Plus Calculator
8xu=TI-83/84 Plus OS Upgrade
aco=Adobe Photoshop Custom Swatch
acp=Microsoft Office Assistant Preview
act=Microsoft Office Assistant Actor
acv=Adobe Photoshop Custom Curve
add=Adobe PageMaker Plugin
add=Microsoft Dynamics AX Application Developer Documentation Data
adi=Microsoft Dynamics AX Application Developer Documentation Index
ado=Adobe Photoshop Duotone Settings
ahd=Microsoft Dynamics AX Online Help Data
ahi=Microsoft Dynamics AX Online Help Index
aip=Adobe Illustrator Plugin
alt=Microsoft Dynamics AX Application Label Temporary File
aoi=Microsoft Dynamics AX Application Object Index
arf=WebEx Advanced Recording
asl=Adobe Photoshop Layer Style
asv=Adobe Photoshop Selective Color
atf=Adobe Photoshop Transfer Functions
ava=Adobe Photoshop Variations File
axx=AxCrypt Encrypted File
backup=Backup Copy File
bak=Backup Copy File
bk=Backup Copy File
blg=Windows Binary Performance Log
btkey=uTorrent License Key
buj=Personal Backup Saved Task
bup=DVD Information Backup
cache=General Cache File
cb=Microsoft Windows 95 Clean Boot File
clp=Windows Clipboard File
cn_=Compressed Windows Help Content
con=OASIS Montaj Control File
cos2=Pinnacle Studio Cache
crc=CRC Checksum
crd=Microsoft Windows Cardfile
crdownload=Chrome Partially Downloaded File
crt=Certificate File
csr=Certificate Signing Request
cvr=Microsoft Crash Report
dbase=Aston-Tate dBASE Database
dbf=Aston-Tate dBASE Database
der=Certificate File
desklink=Windows Desktop Shortcut
diff=Diff Output
dlm=Akamai Download Manager File
docenx=Egis Encrypted File
dos=Renamed MS-DOS System File
dsa=PKCS7 Signature
dzp=DirectorZone Particle Effect
efr=Encryptafile Private Key
efu=Encryptafile Public Key
efw=CA Security Renamed File
egisenc=Egis Encrypted File
es3=e-Szigno Signed Document
et3=e-Szigno Recorded Delivery Data
etl=Windows Event Trace Log
f04=Nastran Log
fdb=Navision Financials Database
file=General File
fin=Corel WordPerfect Saved Find/Search
flp=Flash Project File
flt=Adobe PageMaker Import Filter
flt=General Filter Data
flt=Adobe Audition Filter
fpl=Foobar2000 Playlist
fr=Finalburn Alpha Movie Capture
frelf=Abbyy FineReader Engine License
geo=VRML Geography File
gfs=Groove File Sharing File
gifenx=Egis Encrypted File
glk=Microsoft Office 2007 Groove Synchronization Shortcut
gmp=GUEmap Document
gpl=GPL License File
grp=Windows 3.x Program Manager Group File
hcu=Harmony Controller Update
hfw=Harmony Controller Firmware Update
hme=Smartphone Home Screen Theme
hms=HostMonitor Script
htmlenx=Egis Encrypted File
htt=Windows Web View Template
ica=Citrix ICA Connection Extension
idb=IDA Database
idlk=Adobe InDesign Lock File
ifo=DVD Information File
in=General Input File
index=Index File
inf=Setup Information File
innd=INN MOTD Document
irs=Adobe Photoshop Optimized Settings
isc=ISP Configuration File
jpgenx=Egis Encrypted File
jsf=Macromedia Fireworks Batch Script
kdb=Key Database File
kee=Harpoon 3 Registration Key File
key=General Key Data
khi=Microsoft Dynamics AX Kernel Help Index
ktp=Cakewalk Kinetic Project Template
lck=General Program Lock File
lex=Adobe InDesign Proximity Dictionary
lkd=Pioneer OEL Screensaver
lnk=Windows Shortcut
lock=General Program Lock File
log=Log File
log1=Windows Registry Hive Log
log2=Windows Registry Hive Log
lst=General List File
lwo=Lightwave Object
mapimail=Windows Mail Recipient Shortcut
mcl=Windows Media Center Link
md5=MD5 Checksum
met=Presentation Manager Metafile
mpcpl=Media Player Classic Playlist
mtb=Minitab Exec
mtf=Motorola Phone Theme
mv_=MAGIX Movie Edit Pro Project Backup
mxi=Macromedia Extension Information
mxp=Macromedia Extension Package
mxt3=MobaXterm Packaged Plugins
mydocs=Windows My Documents Shortcut
ncv=Nikon Capture Curve
nrl=Autonomy Interwoven Link
nt=MS-DOS Subsystem Startup File
ntc=Nikon Capture In-camera Custom Curve
nth=Nokia Phone Theme
o=Object File
obj=Object File
old=Backup Copy File
ori=Backup Copy File
orig=Backup Copy File
out=General Output File
p12=Personal Information Exchange File
p2kc=P2K Tools Batch
p2p=FolderShare Placeholder File
pac=Proxy Auto-Config File
part=Partial Download
partial=Internet Explorer Partially Downloaded File
patch=Diff Output
pcb=Microsoft PowerPoint Data
pde=PowerDesk Encrypted File
pdfenx=Egis Encrypted File
pem=PEM Encoded Certificate File
pfl=PhotoFiltre Plugin
pfx=Personal Information Exchange File
pid=Unix Process ID Data
pkcs=PKCS File
plg=Aston Shell Plug-in
plg=Sibelius Plug-in
pls=Multimedia Playlist
plugin=Adobe Photoshop Plugin
pnagent=Citrix Program Neighborhood Agent File
pnf=Precompiled Setup Information File
pol=Windows Group Policy File
ppa=Microsoft PowerPoint Add-in
ppd=PostScript Printer Description
pp_=Compressed PPD File
prj=General Project File
project=Unix Project Information
pset=Adobe InDesign Plug-in Set
psf=Adobe Photoshop Proof Settings
psp=Adobe Photoshop Preferences
pup=Sony Playstation 3 Update Package
pwz=Microsoft PowerPoint Wizard Add-in
qds=Windows Directory Query File
qpa=QuickTime Player Addition
qtp=QuickTime Preferences
qtr=QuickTime Resources
rarenx=Egis Encrypted File
rbs=Windows Installer Rollback Script
reg=Registration Entries
rej=Patch Reject File
req=Canon Camera Request File
rsa=PKCS7 RSA Signature
rsl=Adobe PageMaker Resource
rtsp=Real Time Streaming Protocol Data
rwz=Microsoft Outlook Rules Wizard
safariextz=Apple Safari Extension Package
scm=Gimp Script-Fu Script
scs=Siemens Mobil Phone Color Skin
search-ms=Windows Saved Search
sef=Encryptafile Signature
sf=Digital Signature
sfv=Simple File Verification Checksum
shs=Shell Scrap File
ski=Motorola Phone Theme Skin
sks=Shareaza Skin
skype=Skype Content File
slf=Symantec License File
smrd=Adobe InDesign Import Filter
smwt=Adobe InDesign Export Filter
ssk=SmartSoftKey AMPLock Encrypted File
st5=shntool MD5 Checksum
ste=Dreamweaver Site Definition
switch=Switch Package
sxs=SAS Stat Studio Module
sys=System File
sys=MS-DOS System File
tbp=Aston Toolbar Plug-in
temp=General Temporary File
tmp=General Temporary File
tor=BitTorrent Meta File
torrent=BitTorrent Meta File
tpl=Adobe Photoshop Tool Presets
trashes=Mac OS X Trash Folder
tsk=Pocket PC Theme Skin
url=Internet Shortcut
utz=UIQ Theme Package
vcf=Vevi Configuration File
ver=Version Information
vi1=Virus-Infected File
vi2=Virus-Infected File
vir=Virus-Infected File
vl=Citrix Program Neighborhood Database File
vlt=WinVault File Archive
vsf=Voltage SecureFile Encrypted File
w40=Windows 95 System File Copy
w5s=WinAMP 5 System Plugin
wac=WinAMP Component Plugin
wbs=Winbot Script
wcx=Total Commander Packer Plugin
wdx=Total Commander Content Plugin
webloc=Macintosh URL Shortcut
wer=Windows Error Report
wfx=Total Commander File System Plugin
wlx=Total Commander Lister Plugin
workflow=Automator Workflow
wrf=WebEx Recording
wsp=Adobe ImageReady Application Workspace
xfm=Adobe Audition XFM Plug-in
xia=Chiasmus Encrypted File
xis=Chiasmus Key File
xlsenx=Egis Encrypted File
xlx=XoloX File
xnk=Microsoft Exchange Public Folder Shortcut
xpt=Mozilla Firefox XPCOM Type Library
ymp=YaST Meta Package
zfsendto=Windows Compressed Folder Shortcut
zipenx=Egis Encrypted File
zws=ZiLOG Developer Studio Workspace