acd=Sony ACID Pro Project
acid=Sony ACID Pro Project
actproj=Visual Studio .NET ACT Project
adp=Microsoft Access Project
aep=Adobe After Effects Project
agif=Active GIF Creator Project
agr=Grace Project
as2proj=FlashDevelop Project
as3proj=FlashDevelop Project
ashprj=Ashampoo Burning Studio Project
ata=Antenna Web Design Studio Project
atp=Visual Studio ACT Project
aup=Audacity Project
avp=Avid Media Composer Project
band=GarageBand Project
bdsgroup=Borland Developer Studio Project Group
bdsproj=Borland Developer Studio Project
bld=Broderbund 3D Home Architect Project
cam=Camtasia Studio Project
cbproj=C++ Builder Project
ccs=CodeCharge Studio Project
cd=Wavelab Basic Audio CD Project
cdp=Wavelab Basic CD Project
cp=Adobe Captivate Project
cptx=Adobe Captivate 5 Project
csdproj=Visual Studio .NET Visual C# Smart Device Project
csproj=Visual Studio .NET Visual C# Project
ctd=Sony ClickToDvd Project
cwp=Cakewalk Sonar Project
d2v=Dvd2Avi Project
dbd=DemoShield Project
dmr=BrainVoyager QX Diffusion-Weighted Project
dnt=RSNetWorx Project
docproj=FlashDevelop Documentation Project
dpr=Delphi Project
dsp=Microsoft Developer Studio Project
dtproj=Integration Services Project
dvda=WaveLab DVD Audio Project
dvp=Digital Video Project
dvr=DV Rack Project
eap=Enterprise Architect Project
epp=EditPad Pro Project
ewp=IAR System Project
ewprj=Electronics Workbench Ultiboard Project
fbp5=FinalBuilder Project
fbp6=FinalBuilder Project
fbz5=FinalBuilder Compressed Project
fbz6=FinalBuilder Compressed Project
fcp=Final Cut Pro Project
fcpx=Final Cut Pro X Project
fdp=FlashDevelop Project
fgp=Flash Gallery Builder Project
fgx=Formula Graphics Project
flw=RealFlow Project
fmz=Form Z Project
fog=Fontographer Font Project
fpj=Farsite Project
fsp=Flash Slideshow Builder Project
gdp=Scrolling Game Development Kit Project
gp=Gofer Project
gpr=Babylon Glossary Builder Project
gwp=Microsoft Greetings Workshop Project
hhp=HTML Help Project
hlj=Windows Help Project
hpj=Windows Help Project
hxm=Microsoft Help 2 HxMerge Project
hxp=haXe Project
hxproj=FlashDevelop Project
iax=InstallAnywhere.NET Project
ibb=ImgBurn Project
ipj=Impatica OnCue Project
ipj=Autodesk Inventor Project
ipo=InstallShield Object Project
ipr=InstallShield Project
ipr=IntelliJ IDEA Project
ism=InstallShield Setup Project
iwp=Website X5 Project
iwz=InstallShield Wizard Project
jdv=JDEVS Project
jpr=JBuilder Project
jpx=JBuilder Project
jpx=Borland Together Implementation Project
jsl=Visual J# Project
kpf=Komodo IDE Project
lpu=Passolo Localization Project
mbd=Multimedia Builder Project
mcp=MPLAB IDE Project
mfg=MediaForge Runtime Project
mmp=Master Album Maker Project
mp=Autodesk Maya 3D Project
mpj=Minitab Project
mswmm=Microsoft Windows Movie Maker Project
mvd=Video Files:Movie Edit Pro Video Project
mvp=MAGIX Movie Edit Pro Project
mw2=MicroWorlds Pro Project
mwz=MicroWorlds Pro Compressed Project
ndp=Nick-O-Matic Design Factory Project
nepprj=NEPLAN Project
net=netViz Enterprise Project
ntf=MediaFACE Project
nunit=NUnit Project
opj=Origin Project
otm=Microsoft Outlook VBA Project
pbxproj=Apple Project Builder Xcode Project
pcbprj=Altium PCB Project
piv=Stickfigure Animator Project
pjx=Visual FoxPro Project
pkd=Pover Video Karaoke Project
pkgproj=PacketExpress Project
pkp=Visual Studio Packaging Project
pmj=PhotoMix Project
pmp=PHPMaker Project
pod=OpenProj Project
ppf=Alchemy Publisher Project
ppj=Adobe Premiere Project
ppp=Cyberlink PowerProducer Project
ppr=PSPad Project
pr=Squeak Project
prel=Adobe Premiere Elements Project
prproj=Adobe Premiere Pro Project
pvd=ImageMixer Project
pzp=MGI Photosuite Project
qxp=QuarkXPress Project
rbp=RealBasic Project
rcy=ReCycle Document
rvs=AVEVA Plant Design Management System Project
saproj=SmartAssembly Project
slp=Sisulizer Project
sqz=Sorenson Squeeze Project
ssp=Axialis Screensaver Producer Project
ssproj=SoundSlides Project
stp=Analysis Studio Project
stu=Pinnacle Studio Project
swi=SWiSH Max Project
tcp=TeXnicCenter Project
tlc=The Logo Creator Project
tmproj=TextMate Project
topprj=TopSolid Project
tpx=Borland Together Designer Project
tss=Team Sports Scheduling System Project
twp=WinTWINS Project
uip=Universal Installer Project
vap=Visual Studio Analyzer Project
vba=Visual Basic for Applications Project
vbp=Visual Basic Project
vbproj=Visual Studio .NET Visual Basic Project
vcproj=Visual Studio .NET Visual C++ Project
vdproj=Visual Studio Deployment Project
vdz=Vijeo Designer Project
veg=Sony Vegas Pro Video Project
vgl=VGStudio Project
vip=Microsoft Visual InterDev Project
vmx=Visual Studio Macro Project
vol=Gear CD-ROM Project
vop=Visual OTTHYMO Project
vop=Visual Orangator Project
vpd=VSO PhotoDVD Project
vpj=Nexilogic Pixbend Studio Project
vprj=VideoReDo Project
vsp=Corel VideoStudio Project
vtp=VisionTools Pro-E Project
vts=Intel VTune Project
vup=Visual Studio Utility Project
wcp=WinDVD Creator Project
wdp=WinDev Project
wdproj=Visual Studio Web Deployment Project
wep=ePublisher Stationery Design Project
wit=WebIdeaTree Project
wmmp=Windows Movie Maker Project
wph=WAsP Project
wpj=Microsoft Works Project
wvp=MagicHTML Web Video Player Project
wwp=WebDev Project
xcode=Xcode Project
xcodeproj=Xcode Project
xer=Primavera P6 Project
xmfg=MediaForge Runtime Player Distribution Project
xmp=Xilinx Microprocessor Project
xpr=Microsoft Expression Project
xtc=XTrkCad Project
xtodvd=ConvertXtoDVD Project
xwp=XMLWriter Project
zdp=Avery DesignPro Project
zel=Zelio Soft Project
zgeproj=ZGameEditor Project
zuml=Poseidon for UML Project