264=H.264 Bitstream
3g=3GP Video File
3g2=3GPP2 Video File
3gp=3GP Video File
3gp2=3GPP2 Video File
3gpp=3GP Video File
3gpp2=3GPP2 Video File
3pg=3GP Video File
4xm=4X Movie
ajp=JPEG2000 Digital Surveillance Recorder Video
amc=AMC Video
amv=AMV Encoded Movie
amx=Adobe Motion Exchange Video
asf=Advanced Systems Format Media
ass=Advanced SubStation Alpha Subtitle
asx=Advanced Stream Redirector
avc=Sony AVCHD Video
avchd=Sony AVCHD Video
avi=Microsoft Video for Windows Movie
bik=Bink Video
bink=Bink Video
bix=Kodicom Video
bsf=Blu-ray AVC Video
cbf=BSPlayer Chapter File
cff=Ultraviolet Common File Format
chf=BSPlayer Chapter Information
dav=DVR365 Encrypted Video
dir=Macromedia Director Movie
div=DivX Video
divx=DivX Video
dmb=Digital Multimedia Broadcasting File
dpg=NDS-MPEG Video
dsv=DS Video Movie
dv=Digital Video
dvf=D-Link IP Camera Video
dvf=Panasonic DV Video File
dvr=Microsoft Digital Video Recorder File
dvr-ms=Microsoft Digital Video Recorder File
dvx=DivX Video
dxr=Macromedia Director Protected Movie
evo=HD DVD Enhanced VOB File
eye=ETI Video Recording File
f4f=Flash MP4 Video Fragment
f4v=Flash MP4 Video
filmstrip=Adobe Premiere Filmstrip
flc=Autodesk Animator FLIC File
fli=Autodesk Animator FLIC File
flic=Autodesk Animator FLIC File
flm=Adobe Premiere Filmstrip
flv=Flash Video File
fmv=Famtasia Captured Movie
gvi=Google Video
gvp=Google Video Pointer
h264=H.264 Bitstream
hdmov=HD QuickTime Movie
hdv=High-definition Digital Video
idx=VobSub Subtitle Index
imv=Impatica Video
ismv=IIS Smooth Streaming Video
ivf=Indeo Video File
ivr=Internet Video Recording Stream
k3g=Mobile Video
lrv=GoPro Low Resolution Video
lsf=Streaming Media Format Video
lsx=Streaming Media Shortcut
m1v=Mpeg Video
m2p=Mpeg-2 Program Stream
m2ps=Mpeg-2 Program Stream
m2t=Sony AVCHD Video
m2t=Transport Stream
m2ts=Sony AVCHD Video
m2v=Mpeg Video
m4u=M4U Playlist File
m4v=Mpeg-4 Video Container
map=HD DVD Advanced Content Time Map
mbr=Zune Smooth Streaming File
mcam=MediaCam Video
mj2=Motion JPEG 2000 Video
mjp=MJPEG Video
mjp2=Motion JPEG 2000 Video
mjpeg=MJPEG Video
mjpg=MJPEG Video
mks=Matroska Subtitle
mkv=Matroska Video
mmv=Sony MicroMV Video
mod=HDD Camcorder Video Data
modd=Sony AVCHD Metadata
moff=Sony AVCHD Index
moi=HDD Camcorder Time-Stamp Data
mov=QuickTime Movie
movie=QuickTime Movie
mp2v=Mpeg Video
mp4=Mpeg-4 Video Container
mp4v=Mpeg-4 Video Container
mpb=TruVideo Video-only Stream
mpe=Mpeg Video
mpeg=Mpeg Video
mpeg-4=Mpeg-4 Video Container
mpeg1=Mpeg Video
mpeg2=Mpeg Video
mpeg4=Mpeg-4 Video Container
mpg=Mpeg Video
mpg2=Mpeg Video
mpg4=Mpeg-4 Video Container
mpv=Mpeg Video
mpv2=Mpeg Video
mpv4=Mpeg-4 Video Container
mqv=Sony Clie Video
ms-asf=Advanced Systems Format Media
ms-wmv=Windows Media Video
mve=Interplay Video
mxf=Material eXchange Format
mys=Security Camera Video
npv=Nexilogic Pixbend Video File
nsv=Nullsoft Streaming Video
nuv=MythTV NuppelVideo
ogm=Ogg Media File
ogv=Ogg Video
pgi=Panasonic SD Recorder Timestamp Data
pmf=Sony PSP Movie File
pmp=Portable Media Player Video
pva=PVA Video
pvr=Personal Video Recorder Video
pxv=Nexilogic Pixbend Media File
qt=QuickTime Movie
qtm=QuickTime Movie
rdg=Morae Recorded Video
rm=RealMedia File
rmf=RealMedia File
rms=Secured RealMedia File
rmv=RealMedia Variable Bitrate Video
rmvb=RealMedia Variable Bitrate Video
rtv=NewTek Uncompressed Video
rum=Bink Video Subtitle File
rv=Real Video Movie
rv8=Real Video Movie
rv9=Real Video Movie
scm=ScreenCam Movie
skm=SKM Video
smk=Smacker Video
smov=Sealed Quicktime Movie
smp1=Sealed MPEG-1 Video
smp4=Sealed MPEG-4 Video
smv=SigmaTel Motion Video
srt=SubRip Subtitle Format
ssa=SubStation Alpha Subtitle
str=Sony Playstation Video Stream
sub=VobSub Subtitle
sub=Subtitle Format
svi=Samsung Video File
tdt=AVCHD Thumbnail Data
tid=AVCHD Thumbnail Index
tix=DivX Ticket
tod=JVC Camcorder Video
tp=Beyond TV Transport Stream
tp0=Homecast PVR TP0 Video
ts=Transport Stream
ts4=Technisat Digicorder HD Video
vc1=VC-1 Video
vem=Meta Media Video E-Mail
vfw=Video for Windows Media
vid=Bethesda Softworks Video
viv=VivoActive Video
vlc=VLC Media Player Data
vob=DVD Video Object
vod=DivX Video On Demand Movie
vp6=TrueMotion VP6 Video
vp7=TrueMotion VP7 Video
vqa=Vector Quantized Animation
vro=DVD-VR Video
vse=Video Server E Video
wcc=WinCam 2000 Cache
wcm=WinCam 2000 Movie
wco=WinCam 2000 Distributable Movie
webm=WebM Video
wmv=Windows Media Video
wmx=Windows Media Redirector
wtv=Windows Media Center Recorded TV
wvx=Windows Media Video Redirector
xas=Sony Playstation Video
xmv=Xenon Motion Video
xvid=Microsoft Video for Windows Movie
yuv=Uncompressed YUV Video
zmv=ZSNES Movie